country,year,total_deaths_that_are_from_all_causes__in_both_sexes_aged_all_ages,total_estimated_deaths,difference,share_deaths_with_cause
Antigua and Barbuda,1974,496,376,120,131.9148936
Saint Vincent and the Grenadines,1972,890,694,196,128.2420749
Antigua and Barbuda,1976,491,385,106,127.5324675
Antigua and Barbuda,1977,496,394,102,125.8883249
Grenada,2021,1275,1016,259,125.492126
Antigua and Barbuda,1972,455,374,81,121.657754
Antigua and Barbuda,1975,463,382,81,121.2041885
Kuwait,1998,4215,3501,714,120.3941731
Dominica,2020,700,588,112,119.047619
Malta,1978,3380,2844,536,118.8466948
Kuwait,2001,4364,3696,668,118.0735931
Saint Vincent and the Grenadines,2014,995,845,150,117.7514793
Kuwait,1999,4186,3557,629,117.6834411
Kuwait,2000,4227,3596,631,117.5472747
Antigua and Barbuda,2014,580,494,86,117.4089069
Antigua and Barbuda,1963,574,489,85,117.3824131
Kuwait,1997,4017,3457,560,116.1990165
Martinique,2014,3314,2894,420,114.5127851
Malta,1980,3301,2883,418,114.498786
Seychelles,2011,688,601,87,114.4758735
Antigua and Barbuda,2019,618,540,78,114.4444444
Grenada,2002,888,776,112,114.4329897
Saint Vincent and the Grenadines,2008,804,704,100,114.2045455
Antigua and Barbuda,1966,492,433,59,113.6258661
Singapore,1964,10510,9265,1245,113.4376686
Guadeloupe,2014,3279,2894,385,113.3033863
Kuwait,2002,4342,3833,509,113.2794156
Mayotte,2016,717,633,84,113.2701422
Saint Vincent and the Grenadines,1977,778,688,90,113.0813953
Bahrain,2004,2208,1962,246,112.5382263
Kuwait,1996,3812,3406,406,111.9201409
Seychelles,2013,717,641,76,111.8564743
Seychelles,2005,673,602,71,111.7940199
Singapore,1963,10214,9143,1071,111.7138795
Singapore,1965,10381,9302,1079,111.599656
Trinidad and Tobago,2004,9872,8849,1023,111.5606283
Seychelles,2003,668,599,69,111.5191987
Kuwait,2004,4793,4305,488,111.3356562
Guadeloupe,2016,3227,2899,328,111.3142463
Barbados,1961,2410,2166,244,111.2650046
Kuwait,2006,5247,4716,531,111.259542
Saint Lucia,1987,925,832,93,111.1778846
Seychelles,2009,684,616,68,111.038961
Kuwait,2009,5935,5345,590,111.0383536
Antigua and Barbuda,1971,414,373,41,110.9919571
Bahrain,2003,2107,1900,207,110.8947368
Singapore,1966,10552,9529,1023,110.7356491
Saint Lucia,1992,970,876,94,110.7305936
Barbados,1976,2343,2116,227,110.7277883
Bahrain,2012,2613,2360,253,110.720339
Singapore,1968,11050,9990,1060,110.6106106
Bahrain,2000,2033,1838,195,110.609358
Saint Vincent and the Grenadines,2011,870,787,83,110.5463787
Kuwait,1995,3781,3425,356,110.3941606
Bahrain,2008,2390,2168,222,110.2398524
Malta,2017,3571,3240,331,110.2160494
Trinidad and Tobago,2005,9885,8969,916,110.2129557
Kuwait,2003,4424,4015,409,110.1867995
Saint Lucia,1990,954,866,88,110.1616628
Saint Vincent and the Grenadines,2005,815,740,75,110.1351351
Saint Lucia,1972,971,883,88,109.9660249
Seychelles,2006,664,604,60,109.9337748
Bahrain,2006,2317,2110,207,109.8104265
Malta,1981,3137,2857,280,109.80049
Trinidad and Tobago,2002,9624,8767,857,109.7752937
Malta,1983,3208,2925,283,109.6752137
Malta,1975,3009,2744,265,109.6574344
Singapore,1967,10617,9684,933,109.6344486
Bahrain,2005,2215,2021,194,109.5992083
Kuwait,2008,5701,5203,498,109.5714011
Uruguay,2007,33783,30834,2949,109.5641175
Seychelles,2014,725,662,63,109.5166163
Trinidad and Tobago,2009,9693,8859,834,109.4141551
Antigua and Barbuda,2008,528,483,45,109.3167702
Belize,2000,1534,1404,130,109.2592593
Grenada,2008,857,785,72,109.1719745
Grenada,2014,964,886,78,108.8036117
Saint Vincent and the Grenadines,1970,738,679,59,108.6892489
Maldives,2012,1199,1104,95,108.6050725
Bahrain,2002,2035,1874,161,108.5912487
Martinique,2010,2854,2630,224,108.5171103
Grenada,1994,780,719,61,108.4840056
Antigua and Barbuda,1970,411,379,32,108.4432718
Malta,1987,2956,2728,228,108.3577713
Georgia,2016,50771,46865,3906,108.334578
Seychelles,2008,663,612,51,108.3333333
Belarus,1996,142943,131981,10962,108.305741
Bahrain,1998,1997,1845,152,108.2384824
Bahrain,2001,1979,1831,148,108.0830147
Sri Lanka,1984,100725,93258,7467,108.0068198
Saint Vincent and the Grenadines,2010,823,762,61,108.0052493
Kuwait,2005,4784,4431,353,107.966599
Saint Vincent and the Grenadines,1971,733,679,54,107.9528719
Trinidad and Tobago,2010,10219,9467,752,107.9433823
Uruguay,1999,32431,30082,2349,107.8086563
Uruguay,2003,32577,30236,2341,107.7424262
Martinique,2007,2809,2608,201,107.7070552
Saint Vincent and the Grenadines,2009,777,722,55,107.6177285
Saint Lucia,1993,953,886,67,107.5620767
Guadeloupe,2010,3018,2806,212,107.5552388
Trinidad and Tobago,1998,9636,8960,676,107.5446429
Bahrain,2009,2387,2220,167,107.5225225
Antigua and Barbuda,2017,563,524,39,107.4427481
Trinidad and Tobago,2008,10463,9739,724,107.4340281
Seychelles,2019,795,740,55,107.4324324
Singapore,1973,11920,11100,820,107.3873874
Malta,2015,3443,3208,235,107.3254364
Seychelles,2010,664,619,45,107.26979
Bahrain,2011,2527,2356,171,107.2580645
Malta,1976,3051,2849,202,107.0902071
Romania,2009,257213,240290,16923,107.04274
Trinidad and Tobago,1996,9376,8767,609,106.9465039
Seychelles,2002,647,605,42,106.9421488
Kuwait,2007,5293,4954,339,106.8429552
Trinidad and Tobago,2003,10206,9553,653,106.835549
Puerto Rico,1964,18566,17379,1187,106.8300823
Trinidad and Tobago,2001,9753,9130,623,106.8236583
Malta,1979,3063,2868,195,106.7991632
Antigua and Barbuda,2018,566,530,36,106.7924528
Antigua and Barbuda,1969,410,384,26,106.7708333
Belize,2013,1611,1509,102,106.7594433
Uruguay,1988,30900,28955,1945,106.71732
Antigua and Barbuda,2004,511,479,32,106.6805846
Serbia,1998,99376,93157,6219,106.6758268
South Korea,2001,243813,228813,15000,106.5555716
Chile,1960,95486,89653,5833,106.5061961
Bahrain,2013,2569,2413,156,106.4649814
Romania,2018,264963,248910,16053,106.449319
Saint Vincent and the Grenadines,2007,751,706,45,106.3739377
Romania,2017,262321,246673,15648,106.3436209
Bahrain,2007,2270,2136,134,106.2734082
Uruguay,2004,32193,30337,1856,106.1179418
Barbados,2003,2648,2496,152,106.0897436
South Korea,2002,247524,233316,14208,106.0895952
Trinidad and Tobago,1995,9042,8524,518,106.0769592
Uruguay,1998,31917,30090,1827,106.0717846
Maldives,2011,1182,1115,67,106.0089686
Saint Vincent and the Grenadines,1978,742,700,42,106
Grenada,1990,779,735,44,105.9863946
Mauritius,2021,13274,12527,747,105.9631197
Uruguay,1993,31613,29851,1762,105.9026498
New Zealand,2015,31796,30037,1759,105.8561108
Singapore,1977,11952,11298,654,105.7886352
Saint Vincent and the Grenadines,2006,769,727,42,105.7771664
Uruguay,1980,29823,28196,1627,105.770322
Saint Lucia,1986,847,801,46,105.7428215
Antigua and Barbuda,2016,542,513,29,105.6530214
Martinique,2016,3285,3112,173,105.559126
Saint Lucia,1991,917,869,48,105.5235903
Chile,1962,94874,89913,4961,105.5175559
Uruguay,1984,29990,28426,1564,105.5020052
Chile,1988,74435,70562,3873,105.48879
Singapore,1971,11329,10740,589,105.4841713
Mayotte,2015,635,602,33,105.4817276
Malta,1973,2994,2839,155,105.4596689
Saint Vincent and the Grenadines,2013,911,864,47,105.4398148
Chile,1964,94058,89242,4816,105.3965622
Singapore,1974,11674,11077,597,105.3895459
Uruguay,1995,31700,30080,1620,105.3856383
Malta,1972,2888,2741,147,105.3630062
New Zealand,2014,31164,29588,1576,105.3264837
South Korea,2000,248740,236180,12560,105.3179778
Jamaica,2014,18320,17403,917,105.2692065
Malta,1974,2822,2682,140,105.2199851
Germany,2019,939520,893404,46116,105.1618305
Germany,2018,954874,908011,46863,105.1610608
Martinique,2013,2896,2755,141,105.1179673
Malta,1998,3044,2896,148,105.1104972
Uruguay,1971,28521,27146,1375,105.065203
Georgia,2021,59906,57023,2883,105.0558547
Romania,2019,259889,247408,12481,105.0447035
Romania,2008,253202,241067,12135,105.0338703
Belize,2015,1772,1688,84,104.9763033
Trinidad and Tobago,1994,9264,8825,439,104.9745042
Guadeloupe,2005,2927,2789,138,104.94801
Seychelles,2016,743,708,35,104.9435028
Singapore,1976,11646,11101,545,104.9094676
Barbados,1964,2127,2028,99,104.8816568
Seychelles,2017,754,719,35,104.867872
Kuwait,2012,5950,5677,273,104.8088779
Uruguay,2012,33354,31835,1519,104.7714779
South Korea,1999,247734,236464,11270,104.7660532
Jamaica,2011,16926,16159,767,104.7465809
Georgia,2004,48793,46588,2205,104.7329784
Martinique,2008,2789,2663,126,104.7315058
Guadeloupe,2012,2876,2748,128,104.657933
Belize,2016,1802,1722,80,104.6457607
Georgia,2011,49818,47616,2202,104.624496
Saint Lucia,1988,885,846,39,104.6099291
Greece,2020,131084,125443,5641,104.4968631
Chile,1990,78434,75067,3367,104.4853264
United States,2020,3383729,3238518,145211,104.4838719
Singapore,1975,11447,10958,489,104.4624932
Sri Lanka,1985,98089,93921,4168,104.4377722
Martinique,2011,2730,2614,116,104.4376435
Uruguay,2005,31819,30483,1336,104.3827707
Hong Kong,1974,22043,21122,921,104.3603825
Czechia,2021,139891,134058,5833,104.3511018
Saint Lucia,1981,843,808,35,104.3316832
Bahrain,2010,2401,2302,99,104.3006082
Singapore,1978,12064,11572,492,104.2516419
Singapore,1979,12467,11959,508,104.2478468
Singapore,1972,11522,11053,469,104.2431919
Chile,1965,91648,87919,3729,104.241404
Uruguay,2016,34273,32880,1393,104.236618
Serbia,2000,104042,99844,4198,104.2045591
Italy,2019,641456,615795,25661,104.1671335
Malta,1990,2709,2602,107,104.1122214
Saint Vincent and the Grenadines,2004,785,754,31,104.1114058
Chile,1987,70559,67774,2785,104.1092454
Mayotte,2014,588,565,23,104.0707965
Chile,1986,72209,69399,2810,104.0490497
Guadeloupe,2006,2914,2801,113,104.0342735
Serbia,2001,99008,95184,3824,104.0174819
Malta,1977,2952,2838,114,104.0169133
Belize,2010,1557,1497,60,104.008016
Antigua and Barbuda,2020,574,552,22,103.9855072
Fiji,2001,5764,5544,220,103.968254
Chile,1985,73534,70728,2806,103.9673114
Serbia,2002,102785,98887,3898,103.941873
Antigua and Barbuda,2015,528,508,20,103.9370079
Trinidad and Tobago,2006,9664,9300,364,103.9139785
Chile,1991,74862,72057,2805,103.8927516
Uruguay,1987,29878,28768,1110,103.8584538
Czechia,2020,129289,124567,4722,103.7907311
Seychelles,2007,630,607,23,103.7891269
Malta,1999,3097,2984,113,103.7868633
Saint Vincent and the Grenadines,1974,716,690,26,103.7681159
Georgia,2015,49121,47346,1775,103.7489967
Chile,1989,75453,72745,2708,103.7225926
Puerto Rico,1995,30196,29118,1078,103.7021773
Argentina,1999,289543,279209,10334,103.7011701
North Macedonia,2018,19727,19025,702,103.6898817
Maldives,2014,1157,1116,41,103.6738351
Uruguay,1969,27539,26569,970,103.6508713
Saint Lucia,1976,883,852,31,103.6384977
Trinidad and Tobago,2007,9653,9315,338,103.6285561
Saint Lucia,1980,864,834,30,103.5971223
Romania,2010,259723,250707,9016,103.5962299
Malta,1968,2883,2783,100,103.5932447
Uruguay,2010,32572,31447,1125,103.5774478
Malta,1970,3070,2964,106,103.5762483
Guatemala,2020,96001,92707,3294,103.5531298
Chile,2000,78814,76110,2704,103.5527526
Saint Vincent and the Grenadines,1995,760,734,26,103.5422343
Chile,1973,82988,80152,2836,103.5382773
Uruguay,2001,31178,30113,1065,103.5366785
Trinidad and Tobago,1993,8807,8507,300,103.5265076
Hong Kong,1980,25969,25087,882,103.5157651
Seychelles,2012,651,629,22,103.4976153
Grenada,1995,741,716,25,103.4916201
Israel,2017,44596,43096,1500,103.4806014
Saint Vincent and the Grenadines,1999,833,805,28,103.4782609
North Macedonia,2019,20446,19763,683,103.455953
Grenada,2020,1031,997,34,103.4102307
Serbia,2003,103946,100538,3408,103.3897631
Greece,2019,125016,120923,4093,103.3847986
Chile,1992,74090,71668,2422,103.379472
Uruguay,1996,31110,30107,1003,103.3314512
Chile,1980,73710,71346,2364,103.3134303
Trinidad and Tobago,1999,10014,9693,321,103.3116682
Belarus,1994,130003,125859,4144,103.2925734
Guadeloupe,2009,2922,2829,93,103.2873807
Chile,1984,74669,72293,2376,103.2866253
Grenada,2003,818,792,26,103.2828283
South Korea,1998,245825,238073,7752,103.2561441
Singapore,1985,13347,12927,420,103.2490137
Saint Vincent and the Grenadines,2016,923,894,29,103.2438479
Australia,2021,171469,166082,5387,103.2435785
Fiji,2003,6116,5924,192,103.2410533
Chile,1963,98293,95233,3060,103.2131719
Georgia,2014,49087,47575,1512,103.1781398
Bahrain,1999,1920,1861,59,103.1703385
Chile,1997,78472,76065,2407,103.1643989
Saint Lucia,1994,950,921,29,103.1487514
Uruguay,1990,30210,29293,917,103.1304407
Uruguay,2002,31115,30171,944,103.1288323
Saint Vincent and the Grenadines,2012,859,833,26,103.1212485
Saint Lucia,1983,795,771,24,103.1128405
United Kingdom,2019,603419,585237,18182,103.1067755
Russia,2016,1891015,1834697,56318,103.0696077
North Macedonia,2015,20461,19853,608,103.0625094
Chile,1977,73541,71365,2176,103.0491137
Ireland,2009,28898,28043,855,103.0488892
Malta,2016,3343,3245,98,103.0200308
Greece,1985,92886,90168,2718,103.0143732
Chile,1999,81984,79588,2396,103.0105041
Belize,2011,1555,1510,45,102.9801325
Chile,1981,69871,67858,2013,102.9664888
Malta,1971,3090,3001,89,102.9656781
Kazakhstan,1995,168884,164021,4863,102.9648643
Singapore,1983,13320,12938,382,102.9525429
Greece,2018,120363,117025,3338,102.852382
Guadeloupe,2002,2765,2689,76,102.8263295
Belize,1998,1350,1313,37,102.8179741
Maldives,2013,1141,1110,31,102.7927928
Ukraine,2017,574123,558528,15595,102.7921608
Seychelles,2015,703,684,19,102.7777778
United States,2019,2854838,2778148,76690,102.7604721
Qatar,2006,1754,1707,47,102.7533685
Bahrain,2014,2695,2623,72,102.7449485
Malta,2014,3270,3184,86,102.701005
Dominica,1961,799,778,21,102.6992288
Maldives,2016,1260,1227,33,102.6894866
Greece,2016,118952,115838,3114,102.688237
Chile,1983,74428,72490,1938,102.6734722
Martinique,2009,2758,2687,71,102.6423521
Chile,2002,81079,79000,2079,102.6316456
Russia,1987,1531585,1492331,39254,102.6303816
Turkey,2019,435941,424871,11070,102.6054967
Grenada,2010,828,807,21,102.6022305
Mauritius,2019,11174,10891,283,102.5984758
Uruguay,1972,28319,27608,711,102.5753405
New Zealand,2016,31398,30614,784,102.5609198
Chile,1978,72321,70517,1804,102.5582484
Russia,2017,1826125,1780587,45538,102.5574712
Russia,1986,1497975,1460843,37132,102.54182
Austria,2021,91962,89691,2271,102.5320266
Fiji,2011,6663,6500,163,102.5076923
Chile,1976,79389,77450,1939,102.5035507
United States,1958,1647886,1607673,40213,102.5013171
Chile,1982,69928,68224,1704,102.4976548
Chile,1993,76261,74405,1856,102.494456
Kuwait,2010,5448,5316,132,102.48307
Barbados,1977,2155,2103,52,102.4726581
Belize,2012,1536,1499,37,102.4683122
Guyana,2015,5774,5635,139,102.4667258
North Macedonia,2017,20318,19830,488,102.4609178
United States,1960,1711982,1671107,40875,102.4459834
North Macedonia,2016,20421,19936,485,102.4327849
Grenada,2004,892,871,21,102.4110218
Martinique,2003,2727,2663,64,102.4033045
Barbados,1967,2047,1999,48,102.4012006
United States,1961,1701522,1661721,39801,102.3951674
Greece,2017,124522,121620,2902,102.3861207
United States,1962,1756720,1716019,40701,102.3718269
North Macedonia,2013,19208,18765,443,102.360778
Fiji,2012,6766,6610,156,102.3600605
United States,1965,1828136,1786104,42032,102.3532784
Sri Lanka,1986,95937,93732,2205,102.3524517
United Kingdom,2020,688806,672991,15815,102.3499571
Chile,1972,88658,86623,2035,102.3492606
United States,1963,1813549,1771987,41562,102.3455025
Greece,1986,91783,89680,2103,102.3450045
Saint Vincent and the Grenadines,1998,831,812,19,102.3399015
United States,1972,1963944,1919617,44327,102.3091585
United States,1964,1798051,1757625,40426,102.3000356
Chile,1975,74182,72516,1666,102.297424
Chile,2001,81871,80035,1836,102.2939964
Israel,2016,43966,42981,985,102.2917103
South Korea,1997,244693,239230,5463,102.2835765
Singapore,1970,10790,10550,240,102.2748815
United States,1966,1863149,1821951,41198,102.2612024
United States,1957,1633128,1597038,36090,102.2598085
United States,1971,1927542,1885038,42504,102.2548087
Luxembourg,1991,3830,3746,84,102.2423919
Barbados,1973,2144,2097,47,102.2412971
Maldives,2010,1141,1116,25,102.2401434
Argentina,2012,317144,310203,6941,102.237567
Russia,1988,1569112,1534830,34282,102.2336024
Uruguay,1973,28436,27817,619,102.2252579
Luxembourg,1988,3907,3822,85,102.2239665
United States,1959,1656814,1621018,35796,102.208242
Argentina,2002,291190,284915,6275,102.2024112
Hong Kong,1967,19642,19219,423,102.200947
Kuwait,1985,4710,4609,101,102.1913647
Bahrain,1997,1822,1783,39,102.1873247
United States,1973,1973003,1930819,42184,102.1847724
Chile,1966,90489,88558,1931,102.1804919
Russia,1989,1583743,1549948,33795,102.1803957
United States,1968,1930082,1889161,40921,102.1660938
United States,1967,1851323,1812074,39249,102.1659711
United States,1955,1528717,1496520,32197,102.151458
United States,1956,1564476,1531553,32923,102.1496481
Guatemala,2019,85600,83814,1786,102.1309089
United States,2018,2839205,2780175,59030,102.1232476
United States,1976,1909440,1869770,39670,102.1216513
United States,1975,1892879,1853600,39279,102.1190656
United States,1977,1899597,1860479,39118,102.1025768
United States,1974,1934388,1894914,39474,102.0831552
United States,1969,1921990,1883000,38990,102.070632
United States,1978,1927788,1888740,39048,102.06741
North Macedonia,2012,20134,19727,407,102.0631622
Slovenia,2005,18825,18445,380,102.0601789
Uruguay,2013,32698,32041,657,102.0504978
Chile,1961,91348,89514,1834,102.0488415
Chile,1979,74178,72691,1487,102.0456453
Argentina,1977,238887,234100,4787,102.0448526
Hong Kong,1979,26179,25658,521,102.0305558
Argentina,1992,260153,255015,5138,102.0147834
United States,1970,1921031,1883108,37923,102.0138516
United States,1954,1481091,1452153,28938,101.9927652
Saint Lucia,1989,872,855,17,101.9883041
Serbia,2004,104320,102289,2031,101.9855507
Chile,1968,84560,82921,1639,101.9765801
Guadeloupe,2013,2942,2885,57,101.9757366
Serbia,2005,106771,104725,2046,101.9536882
United States,1953,1517541,1488696,28845,101.9376018
Mauritius,2006,8917,8749,168,101.9202195
Russia,1990,1655993,1624999,30994,101.9073243
Trinidad and Tobago,2012,9616,9437,179,101.8967892
Argentina,1970,222154,218037,4117,101.8882116
Saint Vincent and the Grenadines,1984,706,693,13,101.8759019
Israel,2015,44266,43451,815,101.875676
Antigua and Barbuda,2005,489,480,9,101.875
Russia,2015,1908541,1873440,35101,101.8736122
United States,1980,1989841,1953595,36246,101.8553487
North Macedonia,2009,19060,18713,347,101.8543259
Hong Kong,1976,23189,22767,422,101.85356
Hong Kong,1958,20543,20170,373,101.8492811
Georgia,2012,49348,48452,896,101.8492529
Chile,1959,94491,92781,1710,101.8430498
Israel,2019,46004,45172,832,101.8418489
Hong Kong,1972,21145,20763,382,101.8398112
United States,1979,1913841,1879386,34455,101.8333115
Belarus,1995,133775,131378,2397,101.8245064
Slovenia,2002,18701,18366,335,101.8240227
Slovenia,2003,19451,19103,348,101.8217034
Grenada,1985,783,769,14,101.8205462
Chile,1998,80257,78825,1432,101.8166825
Chile,1995,78531,77134,1397,101.8111339
Uruguay,1977,28919,28406,513,101.8059565
Chile,1967,86840,85305,1535,101.7994256
Guadeloupe,2011,2835,2785,50,101.7953321
Argentina,1993,264402,259747,4655,101.7921285
Saint Lucia,1995,966,949,17,101.7913593
Argentina,1991,253996,249528,4468,101.7905806
Argentina,2013,323327,317641,5686,101.7900712
Hong Kong,1973,21360,20986,374,101.7821405
Chile,1994,75445,74125,1320,101.7807757
Israel,1983,27641,27158,483,101.7784815
Hong Kong,1970,20758,20396,362,101.7748578
Barbados,1979,2128,2091,37,101.7694883
Slovenia,2006,18180,17865,315,101.7632242
Ireland,2018,31140,30601,539,101.7613803
Armenia,2016,28226,27738,488,101.7593193
United States,1950,1452454,1427489,24965,101.7488751
North Macedonia,2008,18982,18657,325,101.7419735
Singapore,1987,13170,12945,225,101.7381228
Hong Kong,1962,20321,19974,347,101.7372584
Slovenia,2001,18508,18192,316,101.7370273
Sri Lanka,1977,103284,101524,1760,101.7335802
Slovenia,2007,18584,18268,316,101.7298007
Trinidad and Tobago,2000,9478,9317,161,101.728024
Singapore,1981,12855,12637,218,101.725093
Martinique,2006,2656,2611,45,101.7234776
Luxembourg,1985,4080,4011,69,101.7202693
Russia,1991,1690657,1662278,28379,101.7072355
Dominica,2019,606,596,10,101.6778523
Kazakhstan,1996,166028,163293,2735,101.6749034
Saint Lucia,1979,850,836,14,101.6746411
Luxembourg,1990,3833,3770,63,101.6710875
Uruguay,1989,29621,29135,486,101.6680968
North Macedonia,2007,19594,19273,321,101.6655425
Chile,2004,86138,84744,1394,101.6449542
Serbia,1999,101444,99809,1635,101.6381288
United States,1952,1496838,1472732,24106,101.6368219
Martinique,2005,2617,2575,42,101.631068
United States,1982,1974797,1943157,31640,101.6282781
United States,1951,1482099,1458412,23687,101.6241638
United States,1981,1977981,1946413,31568,101.6218552
Puerto Rico,1996,29871,29395,476,101.619323
Slovenia,2004,18523,18229,294,101.6128147
Chile,1958,88930,87523,1407,101.6075774
Israel,2018,44537,43833,704,101.6060959
Argentina,1990,256796,252741,4055,101.6044093
Slovenia,2008,18308,18020,288,101.5982242
North Macedonia,2010,19113,18814,299,101.5892421
United States,1983,2019201,1987869,31332,101.5761602
Russia,2018,1828910,1800581,28329,101.5733255
Greece,2015,121485,119604,1881,101.5726899
Argentina,2011,316715,311819,4896,101.5701417
Barbados,1966,2012,1981,31,101.5648662
Argentina,2004,293859,289353,4506,101.5572674
Barbados,2013,2489,2451,38,101.5503876
Romania,2000,255820,251948,3872,101.5368251
Argentina,2007,313772,309024,4748,101.5364502
Grenada,1993,727,716,11,101.5363128
Turkey,2018,426449,420022,6427,101.5301579
Luxembourg,1987,4065,4004,61,101.5234765
Singapore,1980,12502,12318,184,101.493749
United States,2017,2813503,2772099,41404,101.4935975
Bahrain,1987,1569,1546,23,101.4877102
United States,1984,2039369,2009617,29752,101.4804811
Russia,1992,1807441,1781242,26199,101.4708277
Martinique,2015,3055,3011,44,101.4613085
Israel,1975,24600,24247,353,101.4558502
Chile,1996,79123,77989,1134,101.4540512
Jamaica,2009,17222,16980,242,101.4252061
Germany,2020,985572,971767,13805,101.420608
Austria,2020,91599,90324,1275,101.411585
Barbados,1963,2090,2061,29,101.4070839
Slovenia,2009,18750,18491,259,101.4006814
Malta,1985,2915,2875,40,101.3913043
Slovenia,2000,18588,18334,254,101.3854042
Israel,2020,48797,48137,660,101.3710867
Uruguay,1976,28838,28449,389,101.3673591
United States,1985,2086440,2058608,27832,101.3519815
Slovenia,2010,18609,18364,245,101.334132
Seychelles,2004,611,603,8,101.3266998
Argentina,2015,330588,326265,4323,101.3249966
United States,1986,2105361,2077933,27428,101.3199656
Uruguay,1967,26484,26142,342,101.3082396
Grenada,2012,856,845,11,101.3017751
French Guiana,1977,468,462,6,101.2987013
Romania,2001,259603,256309,3294,101.2851675
Uruguay,2015,32967,32549,418,101.2842176
United States,1987,2123323,2096447,26876,101.2819785
Saint Vincent and the Grenadines,1982,717,708,9,101.2711864
Saint Vincent and the Grenadines,2015,879,868,11,101.2672811
Poland,2020,477355,471412,5943,101.2606807
Antigua and Barbuda,1978,402,397,5,101.2594458
Australia,2015,159052,157076,1976,101.2579898
Ireland,2014,29252,28889,363,101.2565336
Ukraine,2014,632296,624547,7749,101.2407393
Greece,1988,92407,91280,1127,101.2346626
Uruguay,2000,30455,30086,369,101.2264841
Chile,1974,78284,77339,945,101.2218932
Romania,1997,279315,275962,3353,101.2150224
Luxembourg,1986,4014,3966,48,101.2102874
Ireland,2012,29186,28837,349,101.2102507
Greece,1987,95656,94521,1135,101.2007914
Serbia,2006,102884,101664,1220,101.2000315
Trinidad and Tobago,1958,7288,7202,86,101.1941127
Romania,1995,271672,268467,3205,101.1938153
Australia,2019,168962,166979,1983,101.1875745
Australia,2008,143946,142269,1677,101.1787529
Ireland,2007,28117,27790,327,101.1766823
Italy,2003,588897,582137,6760,101.1612387
Greece,1983,90586,89547,1039,101.1602845
United States,1988,2167999,2143198,24801,101.1571959
Romania,1999,265194,262164,3030,101.1557651
Malta,2012,3420,3381,39,101.1535049
Uruguay,1997,30454,30108,346,101.1491962
Ireland,2004,28665,28340,325,101.146789
Ireland,2011,28456,28136,320,101.137333
United States,1989,2150466,2126340,24126,101.1346257
United States,1990,2148463,2124914,23549,101.1082331
Luxembourg,1989,4018,3974,44,101.1071968
Slovenia,2011,18699,18495,204,101.1030008
Ireland,2013,29504,29186,318,101.0895635
Ireland,1997,31581,31245,336,101.0753721
Ireland,2001,30212,29891,321,101.0739018
Romania,1998,269166,266312,2854,101.0716753
United States,1991,2169518,2146622,22896,101.066606
Argentina,1995,266171,263363,2808,101.066209
Chile,1970,83166,82292,874,101.0620716
Slovenia,2012,19257,19056,201,101.0547859
Barbados,1972,2108,2086,22,101.05465
Singapore,1969,10287,10180,107,101.0510806
Argentina,2005,293161,290130,3031,101.0447041
Argentina,1998,280180,277302,2878,101.0378576
Argentina,2001,285941,283005,2936,101.0374375
Ireland,2008,28274,27986,288,101.029086
Qatar,2014,2366,2342,24,101.0247652
Israel,1998,36953,36579,374,101.0224446
Saint Kitts and Nevis,2004,396,392,4,101.0204082
Luxembourg,1983,4163,4121,42,101.0191701
Italy,2007,572881,567102,5779,101.0190407
United States,1992,2175613,2153781,21832,101.0136592
Slovenia,1999,18885,18696,189,101.0109114
Guadeloupe,2000,2698,2671,27,101.0108574
Luxembourg,1984,4098,4057,41,101.010599
Romania,1994,266101,263446,2655,101.0077967
Barbados,1968,2045,2025,20,100.9876543
New Zealand,2002,28359,28082,277,100.986397
Ireland,1986,33704,33375,329,100.9857678
Spain,2003,384828,381075,3753,100.9848455
Argentina,2014,322035,318900,3135,100.9830668
North Macedonia,2011,19465,19279,186,100.9647803
Ireland,2005,28260,27991,269,100.9610232
Spain,2001,360131,356716,3415,100.9573442
United States,1993,2268553,2247067,21486,100.9561798
Uruguay,2018,34128,33805,323,100.95548
Israel,2014,42170,41773,397,100.9503746
Puerto Rico,1998,29861,29580,281,100.9499662
Luxembourg,1982,4145,4106,39,100.9498295
Ireland,2000,31391,31096,295,100.9486751
Australia,1971,110650,109612,1038,100.9469766
Ireland,2015,30127,29845,282,100.9448819
Russia,2019,1798307,1781485,16822,100.9442684
Spain,2002,368618,365172,3446,100.9436649
Guadeloupe,2008,2794,2768,26,100.9393064
Uruguay,2019,34807,34484,323,100.9366663
Ireland,2003,29074,28806,268,100.9303617
Spain,1995,346227,343049,3178,100.9263983
Martinique,2004,2647,2623,24,100.9149828
Spain,2004,371934,368567,3367,100.9135381
Italy,2006,558614,553567,5047,100.9117234
Argentina,2016,350117,346954,3163,100.9116482
Uruguay,2020,32637,32343,294,100.9090066
Ireland,2006,28482,28226,256,100.9069652
Ireland,1998,31563,31280,283,100.9047315
Israel,1999,37291,36958,333,100.9010228
Grenada,2009,788,781,7,100.8962868
Israel,2000,37688,37354,334,100.8941479
Spain,1996,351449,348349,3100,100.8899121
United States,2016,2744248,2720154,24094,100.8857587
Israel,1997,36106,35789,317,100.885747
Israel,2007,39948,39600,348,100.8787879
New Zealand,2001,28128,27883,245,100.8786716
Spain,1994,338242,335310,2932,100.8744147
Israel,2013,41479,41120,359,100.8730545
South Korea,2003,246463,244333,2130,100.8717611
United States,1994,2278994,2259317,19677,100.8709269
Spain,1998,360511,357409,3102,100.8679132
Italy,2005,568328,563488,4840,100.8589358
Argentina,2017,341688,338780,2908,100.8583742
Italy,2004,545051,540418,4633,100.8572993
Dominica,1969,716,710,6,100.8450704
Spain,1997,349521,346597,2924,100.8436311
Chile,1969,84680,83975,705,100.8395356
Spain,1999,371102,368015,3087,100.8388245
Ireland,1992,30931,30674,257,100.8378431
Slovenia,1998,19039,18881,158,100.8368201
Ireland,1995,32259,31992,267,100.8345836
Spain,2006,371478,368414,3064,100.8316731
Spain,2005,387355,384161,3194,100.8314222
Ireland,2002,29683,29439,244,100.8288325
Luxembourg,1981,4160,4126,34,100.8240427
Ireland,1996,31723,31464,259,100.823163
Netherlands,2020,168678,167303,1375,100.8218621
Ireland,1991,31301,31046,255,100.8213619
United States,1995,2312132,2293366,18766,100.8182732
Antigua and Barbuda,2012,493,489,4,100.8179959
New Zealand,2004,28645,28413,232,100.8165276
Ireland,1999,32608,32345,263,100.8131087
Antigua and Barbuda,1999,500,496,4,100.8064516
Israel,1984,27805,27583,222,100.8048436
Italy,2013,599698,594922,4776,100.8027943
Italy,2008,581470,576842,4628,100.8022994
Slovenia,1997,18928,18778,150,100.7988071
Spain,2007,385361,382309,3052,100.7983071
Israel,2012,41877,41547,330,100.7942812
New Zealand,2009,29204,28974,230,100.7938151
Italy,2012,613520,608698,4822,100.7921827
Egypt,2015,573879,569391,4488,100.7882106
Slovenia,2013,19334,19183,151,100.7871553
Spain,2000,360391,357583,2808,100.7852722
Spain,1987,310073,307663,2410,100.7833246
Italy,2009,588438,583877,4561,100.7811577
Ireland,1993,32148,31899,249,100.7805887
Ukraine,2018,587665,583125,4540,100.7785638
United States,1996,2314690,2297000,17690,100.770135
Italy,2010,584615,580159,4456,100.7680653
Ireland,1994,30948,30713,235,100.7651483
New Zealand,1991,26490,26292,198,100.7530808
Italy,2011,594153,589769,4384,100.7433419
Ireland,1990,31370,31140,230,100.7385999
Spain,1988,319437,317101,2336,100.7366738
Sao Tome and Principe,1984,1231,1222,9,100.7364975
Ireland,1973,34192,33943,249,100.7335828
Puerto Rico,1963,17350,17225,125,100.7256894
Barbados,2005,2503,2485,18,100.7243461
Portugal,2000,105813,105056,757,100.7205681
Ireland,1981,32929,32694,235,100.7187863
Portugal,1995,103939,103213,726,100.7033998
Georgia,2010,47864,47530,334,100.7027141
Ireland,1983,32976,32748,228,100.6962257
Ireland,1972,34381,34144,237,100.694119
Portugal,1973,95435,94781,654,100.6900117
Portugal,1992,101161,100475,686,100.6827569
Portugal,1993,106384,105663,721,100.6823581
United Kingdom,2001,604393,600307,4086,100.6806517
Spain,2008,386324,383718,2606,100.6791446
Portugal,1988,98236,97575,661,100.6774276
North Macedonia,2006,18630,18505,125,100.6754931
Ireland,1989,32111,31896,215,100.6740657
Portugal,1989,96220,95578,642,100.6717027
Estonia,1994,22212,22064,148,100.6707759
United States,1997,2314245,2298834,15411,100.6703833
Norway,1958,31645,31435,210,100.6680452
Luxembourg,1968,4112,4085,27,100.6609547
Spain,2011,387911,385365,2546,100.6606723
Spain,1992,331515,329353,2162,100.6564385
Portugal,2001,105582,104894,688,100.6559002
Ireland,1979,33771,33551,220,100.6557182
Sri Lanka,1983,95174,94555,619,100.6546454
Australia,2010,143473,142544,929,100.6517286
Portugal,1974,97034,96407,627,100.6503677
New Zealand,2010,28649,28465,184,100.6464079
Romania,1996,286158,284331,1827,100.642561
Singapore,1984,13161,13077,84,100.6423492
Spain,1980,289344,287498,1846,100.6420914
Canada,1965,148939,147990,949,100.6412595
United States,1998,2337256,2322433,14823,100.6382531
Ireland,1980,33472,33260,212,100.6374023
Uruguay,1994,30186,29995,191,100.6367728
Portugal,1991,104361,103702,659,100.6354747
Slovenia,1996,18620,18503,117,100.6323299
Spain,1978,296781,294919,1862,100.6313598
Luxembourg,1967,4154,4128,26,100.629845
Portugal,1977,96111,95511,600,100.6281999
Ireland,1987,31405,31209,196,100.628024
Puerto Rico,1961,16361,16259,102,100.6273449
Ireland,1988,31580,31384,196,100.624522
Puerto Rico,1993,28492,28317,175,100.6180033
Spain,1982,286655,284895,1760,100.6177715
Spain,1993,339661,337577,2084,100.6173406
Italy,2016,618083,614303,3780,100.6153315
Ireland,1985,33213,33010,203,100.6149652
Puerto Rico,1989,25985,25827,158,100.6117629
New Zealand,1994,27095,26931,164,100.6089636
Czechia,2019,112362,111682,680,100.6088716
Slovenia,2015,19834,19715,119,100.6036013
Finland,1977,44276,44011,265,100.6021222
Cuba,1993,78531,78062,469,100.6008045
Canada,1966,149863,148971,892,100.5987743
New Zealand,1995,27956,27790,166,100.5973372
Chile,2003,83672,83178,494,100.593907
Italy,2015,646048,642236,3812,100.5935513
Spain,1991,337691,335723,1968,100.5861975
Ireland,1982,32457,32268,189,100.5857196
Spain,1989,324796,322918,1878,100.5815718
Spain,1986,310413,308624,1789,100.5796698
Portugal,1979,92732,92201,531,100.5759157
Armenia,2020,36170,35963,207,100.5755916
Spain,1990,333142,331236,1906,100.5754205
Saint Vincent and the Grenadines,1983,700,696,4,100.5747126
Portugal,1986,95828,95281,547,100.5740914
United Kingdom,2002,608045,604584,3461,100.5724597
Italy,2014,598670,595270,3400,100.5711694
Sweden,2004,91079,90564,515,100.5686586
New Zealand,2008,29312,29147,165,100.566096
Portugal,2008,104768,104180,588,100.5644078
Spain,2018,427721,425324,2397,100.5635704
Portugal,1997,105157,104571,586,100.5603848
Norway,1956,29981,29814,167,100.5601395
Israel,2010,39418,39199,219,100.5586877
Portugal,1978,96194,95661,533,100.5571759
Ireland,1977,33632,33447,185,100.5531139
Portugal,1987,95423,94904,519,100.5468684
Israel,2011,40668,40447,221,100.546394
Uruguay,1974,28287,28134,153,100.543826
United States,2000,2403351,2390401,12950,100.5417501
United States,2001,2416425,2403429,12996,100.5407274
Portugal,2003,109148,108562,586,100.5397837
Spain,2019,418703,416467,2236,100.5368973
Portugal,1980,94971,94470,501,100.5303271
Spain,2017,424523,422287,2236,100.5294977
New Zealand,2013,29636,29480,156,100.5291723
Portugal,1996,107259,106695,564,100.5286096
Luxembourg,1979,3995,3974,21,100.5284348
Portugal,1994,99621,99099,522,100.526746
Finland,2020,55498,55208,290,100.5252862
Malta,1991,2872,2857,15,100.5250263
United States,1999,2391399,2378946,12453,100.5234671
Malta,1993,2692,2678,14,100.5227782
Belgium,1981,112974,112387,587,100.5223024
Spain,1977,294324,292796,1528,100.5218651
Spain,2015,422568,420377,2191,100.5211988
Romania,1966,157445,156631,814,100.5196928
Portugal,1971,98688,98180,508,100.517417
Portugal,1985,97339,96838,501,100.5173589
Spain,1983,302569,301015,1554,100.5162533
Malta,2001,2935,2920,15,100.5136986
Luxembourg,1993,3916,3896,20,100.513347
Georgia,2017,47822,47578,244,100.5128421
Fiji,2008,6471,6438,33,100.5125815
Ireland,1974,34921,34743,178,100.5123334
Luxembourg,1972,4122,4101,21,100.5120702
Australia,1980,108695,108144,551,100.5095058
Portugal,1998,106574,106034,540,100.5092706
Israel,1996,34658,34483,175,100.5074964
Turkey,2017,423819,421687,2132,100.5055883
Uruguay,1983,28473,28330,143,100.5047653
Spain,1984,299409,297909,1500,100.5035095
Ireland,1978,33794,33625,169,100.5026022
Argentina,2019,341728,340033,1695,100.498481
Romania,1993,263323,262021,1302,100.4969067
Spain,1975,298192,296718,1474,100.496768
Portugal,1990,103115,102607,508,100.4950929
Israel,1995,35348,35174,174,100.4946836
Spain,2009,384933,383049,1884,100.4918431
Israel,1980,26278,26150,128,100.4894837
United Kingdom,1964,611130,608167,2963,100.4872017
Romania,1992,263855,262577,1278,100.4867144
Ireland,1969,33734,33571,163,100.4855381
Portugal,1976,102027,101535,492,100.484562
Portugal,2002,106690,106177,513,100.4831555
United States,2015,2712630,2699590,13040,100.4830363
New Zealand,2006,28389,28253,136,100.4813648
Hungary,2011,128795,128178,617,100.4813619
Spain,2016,410611,408659,1952,100.4776599
Guatemala,2016,82565,82176,389,100.4733742
Chile,2005,86102,85697,405,100.4725953
Portugal,1983,96367,95915,452,100.4712506
Estonia,2013,15374,15302,72,100.4705267
Portugal,2009,104964,104473,491,100.4699779
Portugal,1984,97227,96775,452,100.4670628
Ireland,1984,32076,31927,149,100.4666896
Slovenia,1995,18968,18880,88,100.4661017
Finland,1982,43582,43380,202,100.4656524
Iceland,2013,2158,2148,10,100.4655493
Spain,2014,395830,393997,1833,100.465232
Portugal,1972,90315,89897,418,100.4649766
Portugal,2013,106876,106382,494,100.4643643
Canada,1964,145850,145180,670,100.4614961
United Kingdom,2004,584791,582109,2682,100.4607385
Australia,1968,109547,109046,501,100.4594391
Armenia,2010,27921,27794,127,100.4569332
Finland,1981,44528,44326,202,100.4557145
Argentina,2006,292313,290998,1315,100.4518931
New Zealand,2012,30277,30141,136,100.4512126
Israel,2001,37187,37020,167,100.4511075
New Zealand,2011,30290,30154,136,100.4510181
New Zealand,1993,27211,27089,122,100.4503673
Spain,2013,390419,388671,1748,100.4497377
Finland,1983,45519,45316,203,100.4479654
United Kingdom,1965,627798,625005,2793,100.4468764
Iceland,2018,2258,2248,10,100.4448399
Argentina,2010,316298,314899,1399,100.4442694
Iceland,1986,1598,1591,7,100.4399749
United Kingdom,2003,612085,609420,2665,100.437301
Poland,1964,235919,234892,1027,100.4372222
South Korea,2005,245874,244811,1063,100.4342125
Portugal,1999,108268,107802,466,100.432274
Canada,1968,153196,152538,658,100.4313679
Norway,1951,27736,27617,119,100.430894
Portugal,1982,92551,92156,395,100.428621
Spain,2010,382047,380417,1630,100.4284772
Spain,1981,293386,292136,1250,100.4278829
Barbados,1974,2113,2104,9,100.4277567
Serbia,2007,102805,102368,437,100.4268912
Finland,1985,48345,48140,205,100.4258413
Spain,2012,402950,401253,1697,100.4229252
Finland,2004,47757,47556,201,100.4226596
Hong Kong,1963,19734,19651,83,100.4223704
Australia,1977,108790,108334,456,100.4209205
United States,2002,2443387,2433211,10176,100.4182128
Poland,1966,232945,231977,968,100.4172827
Malta,1984,2929,2917,12,100.4113816
Luxembourg,1971,4402,4384,18,100.4105839
Canada,1967,150283,149670,613,100.4095677
Portugal,2014,105219,104791,428,100.408432
United States,2003,2448288,2438341,9947,100.4079413
Canada,1970,155961,155330,631,100.4062319
Ireland,1967,31400,31273,127,100.4061011
Ireland,1970,33686,33550,136,100.4053651
Argentina,1969,223205,222306,899,100.4043975
Iceland,2017,2236,2227,9,100.4041311
Ireland,1976,34043,33906,137,100.4040583
Spain,1976,299007,297814,1193,100.4005856
Uruguay,1986,28772,28658,114,100.3977947
Finland,1986,47308,47121,187,100.3968507
Portugal,2007,103888,103478,410,100.3962195
Mexico,1970,485656,483743,1913,100.3954579
Poland,1961,227759,226864,895,100.3945095
Slovenia,2014,18886,18812,74,100.3933659
Romania,1968,188509,187775,734,100.3908934
Canada,1962,143699,143140,559,100.3905268
New Zealand,2007,28601,28490,111,100.3896104
Ireland,1968,33157,33029,128,100.3875382
Ireland,1971,31890,31767,123,100.3871943
Estonia,1982,17893,17824,69,100.3871185
New Zealand,1992,27252,27147,105,100.3867831
Ireland,1962,33838,33708,130,100.3856651
South Korea,1995,242838,241909,929,100.3840287
New Zealand,1980,26688,26586,102,100.3836606
Trinidad and Tobago,2011,9438,9402,36,100.3828973
Australia,1956,86088,85760,328,100.3824627
New Zealand,1990,26524,26423,101,100.3822427
Finland,1980,44513,44344,169,100.3811113
Hungary,1955,97848,97477,371,100.3806026
Finland,1979,43859,43693,166,100.3799236
Poland,1965,232421,231547,874,100.3774612
Australia,2011,146932,146380,552,100.3771007
Sweden,1999,95076,94721,355,100.3747849
Armenia,2015,27878,27774,104,100.3744509
South Korea,2004,246220,245302,918,100.3742326
Poland,1963,230072,229230,842,100.3673167
Sweden,1998,93628,93286,342,100.3666145
Ukraine,2007,762877,760091,2786,100.3665351
Canada,1963,147367,146829,538,100.3664126
Portugal,2016,110970,110566,404,100.3653926
Kuwait,1982,4992,4974,18,100.3618818
Poland,1967,247705,246812,893,100.3618139
Ukraine,2008,754460,751758,2702,100.3594242
France,2011,536628,534724,1904,100.3560715
Estonia,1999,18454,18389,65,100.3534722
Saint Lucia,1975,858,855,3,100.3508772
Ireland,1963,33795,33677,118,100.3503875
Poland,1962,239199,238371,828,100.3473577
Luxembourg,1975,4375,4360,15,100.3440367
Fiji,2006,6140,6119,21,100.3431933
Russia,1993,2129339,2122065,7274,100.3427793
Spain,1985,312532,311467,1065,100.3419303
Trinidad and Tobago,1997,9157,9126,31,100.3396888
Australia,1974,115833,115441,392,100.3395674
Portugal,1981,95892,95569,323,100.3379757
Poland,1959,252430,251584,846,100.3362694
Belgium,1982,112428,112052,376,100.3355585
Norway,2007,41963,41823,140,100.334744
Italy,2018,632940,630845,2095,100.3320943
North Macedonia,2004,17948,17889,59,100.3298116
Canada,1960,139693,139237,456,100.3274992
United Kingdom,1963,654288,652157,2131,100.3267618
Portugal,2012,107969,107622,347,100.3224248
Norway,1998,44270,44131,139,100.3149713
Spain,1979,290672,289760,912,100.3147432
Estonia,1997,18566,18508,58,100.313378
Iceland,1995,1923,1917,6,100.312989
Argentina,1988,252949,252162,787,100.312101
France,2005,527516,525879,1637,100.3112883
Portugal,2011,103203,102883,320,100.3110329
Finland,1978,43818,43683,135,100.3090447
Canada,1961,140985,140552,433,100.308071
New Zealand,1998,26457,26376,81,100.3070974
Slovenia,1994,19359,19300,59,100.3056995
Canada,1950,123789,123412,377,100.3054808
Chile,1971,83240,82987,253,100.304867
Australia,1951,81788,81541,247,100.3029151
Australia,1950,78187,77952,235,100.3014676
United Kingdom,2005,582964,581215,1749,100.3009213
Finland,2012,51737,51582,155,100.3004924
Norway,1959,31761,31668,93,100.2936718
Portugal,1975,97936,97650,286,100.2928827
Hungary,1958,97866,97581,285,100.2920651
Finland,1995,49325,49182,143,100.2907568
Australia,1975,109021,108707,314,100.2888498
Australia,1962,93163,92897,266,100.2863386
Portugal,2010,106242,105946,296,100.2793876
Estonia,1981,18349,18298,51,100.278719
Italy,2002,560390,558834,1556,100.2784369
Norway,1988,45404,45278,126,100.2782808
Canada,1959,139913,139525,388,100.2780864
United Kingdom,1997,629746,628023,1723,100.274353
Australia,2017,161083,160643,440,100.2738993
Portugal,2017,110191,109892,299,100.2720853
Czechia,2018,112920,112614,306,100.2717247
Slovakia,2008,53164,53021,143,100.2697045
Switzerland,2020,76195,75992,203,100.2671334
Antigua and Barbuda,1973,377,376,1,100.2659574
United Kingdom,2007,574687,573184,1503,100.2622195
Israel,2005,38897,38796,101,100.2603361
Australia,1992,122908,122590,318,100.2594013
Estonia,1985,19343,19293,50,100.2591614
New Zealand,2000,26718,26649,69,100.2589215
Switzerland,2012,64173,64008,165,100.2577803
Italy,1991,553833,552410,1423,100.2575985
Hong Kong,1959,20242,20190,52,100.2575532
Norway,1996,43919,43807,112,100.2556669
Argentina,2003,301870,301102,768,100.2550631
United Kingdom,1996,636007,634402,1605,100.2529942
Sweden,2013,90505,90277,228,100.252556
United States,2004,2397615,2391583,6032,100.2522179
Finland,2018,54523,54386,137,100.2519031
Finland,1987,47985,47865,120,100.2507051
New Zealand,1952,18896,18849,47,100.2493501
Norway,1967,36216,36126,90,100.2491281
France,2003,552335,550965,1370,100.2486546
Australia,1984,113312,113031,281,100.2486044
Hungary,2019,129603,129283,320,100.247519
Austria,2007,74625,74442,183,100.245829
Ireland,1966,35113,35027,86,100.2455249
Italy,2001,556892,555539,1353,100.2435473
Germany,1991,911245,909044,2201,100.2421225
United Kingdom,1998,629172,627654,1518,100.241853
Italy,1996,554576,553240,1336,100.2414865
Sweden,2017,92075,91854,221,100.2405992
United Kingdom,2011,552232,550909,1323,100.2401486
Estonia,2000,18403,18359,44,100.2396645
United Kingdom,2008,579697,578312,1385,100.2394901
Italy,1997,561207,559867,1340,100.2393426
Hungary,1957,103645,103398,247,100.2388828
Canada,1971,157272,156901,371,100.2364548
Ukraine,2004,761261,759468,1793,100.2360863
United States,2005,2448017,2442263,5754,100.2356012
Australia,1963,94894,94672,222,100.2344938
New Zealand,1951,18836,18792,44,100.2341422
United Kingdom,2016,597204,595812,1392,100.2336307
Norway,2008,41716,41619,97,100.2330666
Greece,2014,113740,113476,264,100.2326483
Australia,1959,89212,89005,207,100.2325712
Belgium,1986,112039,111784,255,100.2281185
Finland,1993,51028,50912,116,100.2278441
New Zealand,1950,18084,18043,41,100.2272349
United Kingdom,2012,569024,567739,1285,100.2263364
Australia,1973,110822,110577,245,100.2215651
Finland,2015,52302,52187,115,100.2203614
France,2004,509419,508305,1114,100.2191598
Canada,1958,135201,134907,294,100.2179279
Norway,1989,45241,45143,98,100.2170879
Norway,2003,42550,42458,92,100.2166847
Estonia,2001,18516,18476,40,100.2164971
Portugal,2015,108922,108687,235,100.2162172
United Kingdom,1966,643754,642372,1382,100.2151401
United Kingdom,2000,608366,607061,1305,100.2149702
Australia,1970,113048,112806,242,100.2145276
Italy,1998,574231,573018,1213,100.2116862
Ireland,1975,33173,33103,70,100.2114612
Estonia,2005,17316,17280,36,100.2083333
Belgium,1980,114033,113796,237,100.2082674
Australia,1982,114071,113838,233,100.2046768
Poland,1968,244115,243617,498,100.2044192
Slovakia,2002,51532,51427,105,100.2041729
Finland,1958,38833,38754,79,100.2038499
Australia,1955,82036,81870,166,100.2027605
Australia,1954,81805,81640,165,100.2021068
Finland,1989,49129,49030,99,100.2019172
Finland,1957,40741,40659,82,100.2016774
Italy,1969,539129,538045,1084,100.2014701
Iceland,1974,1495,1492,3,100.2010724
Canada,2000,218062,217626,436,100.2003437
Switzerland,1955,50366,50266,100,100.1989416
Finland,1971,45875,45784,91,100.1987594
Finland,2013,51478,51376,102,100.1985363
Slovenia,2016,19689,19650,39,100.1984733
Italy,2000,560121,559012,1109,100.1983857
Philippines,2019,620414,619189,1225,100.1978394
Italy,1965,518008,516986,1022,100.1976843
Ukraine,2009,706739,705347,1392,100.1973497
Australia,1996,128254,128002,252,100.1968719
Canada,2016,267213,266688,525,100.1968593
New Zealand,1953,18354,18318,36,100.196528
Norway,1969,38994,38918,76,100.1952824
Finland,1976,44863,44776,87,100.1943005
Singapore,1982,12895,12870,25,100.1942502
Ukraine,2006,758092,756630,1462,100.1932252
Estonia,1995,20828,20788,40,100.1924187
Estonia,2002,18355,18320,35,100.191048
Finland,1992,49852,49757,95,100.1909279
Netherlands,1971,110243,110033,210,100.1908518
Czechia,2010,106844,106641,203,100.1903583
Hungary,1995,145431,145155,276,100.1901416
Norway,1962,34318,34253,65,100.1897644
New Zealand,1966,23778,23733,45,100.1896094
Armenia,1993,27500,27448,52,100.1894491
Barbados,1962,2116,2112,4,100.1893939
Norway,1954,29158,29103,55,100.188984
Romania,2011,251439,250965,474,100.188871
United Kingdom,2009,559617,558565,1052,100.1883398
New Zealand,1958,20301,20263,38,100.1875339
Canada,1973,164039,163732,307,100.1875015
Norway,1966,36010,35943,67,100.1864063
Martinique,2000,2692,2687,5,100.1860811
Finland,1972,43959,43878,81,100.1846028
Sweden,2014,89062,88898,164,100.1844811
Estonia,1993,21286,21247,39,100.1835553
Slovakia,2019,53234,53137,97,100.182547
Italy,1995,556690,555676,1014,100.1824804
Australia,1960,88464,88303,161,100.1823268
Sweden,1997,93349,93180,169,100.1813694
United Kingdom,2010,561666,560655,1011,100.1803248
Sweden,2003,93003,92836,167,100.1798871
Ukraine,2002,754911,753559,1352,100.1794153
South Korea,2006,244162,243726,436,100.1788894
Netherlands,1972,113576,113374,202,100.1781714
Canada,1969,154477,154203,274,100.1776879
Poland,1969,262823,262357,466,100.1776206
Finland,1953,39925,39855,70,100.1756367
Sweden,2012,91990,91829,161,100.1753259
Portugal,2019,112334,112138,196,100.1747846
Finland,1991,49306,49220,86,100.1747257
Belgium,1983,114876,114676,200,100.1744044
Estonia,1990,19531,19497,34,100.1743858
Poland,1960,224167,223778,389,100.173833
Czechia,2008,104948,104766,182,100.1737205
Australia,1964,100594,100420,174,100.1732723
Italy,1976,550565,549614,951,100.1730305
Italy,1966,496281,495425,856,100.1727809
Switzerland,2016,64964,64852,112,100.1727009
Netherlands,1975,113737,113541,196,100.1726249
Norway,1960,32543,32487,56,100.1723766
Italy,1977,546694,545755,939,100.1720552
Israel,1992,33327,33270,57,100.1713255
Germany,1990,921445,919871,1574,100.1711109
Finland,1984,45131,45054,77,100.170906
United Kingdom,2015,602781,601754,1027,100.1706677
Czechia,1995,117913,117713,200,100.1699048
Finland,1963,42010,41939,71,100.1692935
Australia,1985,117806,117607,199,100.1692076
Canada,1972,162413,162139,274,100.1689908
United States,2007,2423895,2419808,4087,100.1688977
Australia,1952,81597,81460,137,100.1681807
United Kingdom,1995,645493,644410,1083,100.1680607
United Kingdom,1950,590136,589147,989,100.1678698
Portugal,1963,98011,97847,164,100.1676086
Israel,1979,25700,25657,43,100.1675956
Norway,1968,37668,37605,63,100.1675309
Estonia,1989,18536,18505,31,100.1675223
Austria,2001,74767,74642,125,100.167466
Israel,1993,33000,32945,55,100.1669449
Australia,1961,88961,88814,147,100.1655144
Norway,1986,43666,43594,72,100.1651603
Finland,2006,48106,48027,79,100.1644908
New Zealand,1999,28224,28178,46,100.1632479
United Kingdom,1973,669692,668601,1091,100.1631765
Canada,1980,171473,171194,279,100.162973
United Kingdom,1994,627636,626617,1019,100.1626193
Switzerland,1958,49281,49201,80,100.1625983
Germany,1993,897270,895815,1455,100.1624219
New Zealand,1973,25290,25249,41,100.1623827
Hungary,1997,139434,139208,226,100.162347
Slovenia,2017,20509,20476,33,100.1611643
Hungary,1992,148781,148542,239,100.1608973
Reunion,2005,4365,4358,7,100.1606241
Germany,1992,885443,884025,1418,100.1604027
Italy,1988,539426,538568,858,100.1593114
Finland,1969,45966,45893,73,100.1590657
Sweden,1957,73132,73016,116,100.1588693
Netherlands,1976,114454,114274,180,100.1575161
Australia,1994,126982,126783,199,100.1569611
Switzerland,2011,62089,61992,97,100.1564718
Czechia,2012,108189,108020,169,100.1564525
Hungary,2013,126778,126580,198,100.1564228
Italy,1967,510122,509328,794,100.1558917
Norway,1952,28417,28373,44,100.155077
Sweden,2016,91071,90930,141,100.1550643
Estonia,1998,19446,19416,30,100.1545117
Switzerland,1967,55142,55057,85,100.1543855
Sweden,2008,91542,91401,141,100.1542653
United States,2006,2426299,2422573,3726,100.1538034
Austria,2013,79526,79404,122,100.1536447
United Kingdom,2006,572224,571347,877,100.1534969
Ukraine,1996,776717,775534,1183,100.1525401
Belgium,1984,111073,110904,169,100.152384
Ukraine,2005,781961,780775,1186,100.1519004
Czechia,2002,108243,108079,164,100.1517409
Canada,2012,246596,246225,371,100.1506752
Estonia,1986,17986,17959,27,100.1503424
Netherlands,2003,141936,141723,213,100.1502932
France,2008,532474,531678,796,100.1497147
United Kingdom,1999,632062,631120,942,100.1492585
Saint Vincent and the Grenadines,1990,671,670,1,100.1492537
Austria,2003,77209,77094,115,100.1491685
Finland,2003,49033,48960,73,100.1491013
Finland,1988,49090,49017,73,100.1489279
Italy,1989,531853,531063,790,100.1487582
Sweden,2000,93516,93378,138,100.1477864
Puerto Rico,1965,17686,17660,26,100.1472254
Austria,1998,78339,78224,115,100.1470137
Sweden,1959,70889,70785,104,100.1469238
Canada,2010,240075,239723,352,100.1468361
Netherlands,1973,110682,110520,162,100.1465798
Czechia,2009,107421,107264,157,100.1463678
Hungary,1959,103880,103729,151,100.1455716
Australia,1957,84953,84830,123,100.1449959
Australia,1953,80188,80072,116,100.1448696
Italy,1951,481911,481215,696,100.1446339
Finland,1996,49161,49090,71,100.1446323
United Kingdom,1951,632786,631875,911,100.1441741
Italy,1990,543708,542928,780,100.1436655
Norway,1997,44646,44582,64,100.1435557
Norway,1973,39958,39901,57,100.1428536
Hungary,2010,130456,130270,186,100.1427804
Spain,2020,493776,493075,701,100.142169
Ukraine,1995,792615,791491,1124,100.1420105
France,2010,541576,540813,763,100.1410839
Iceland,1978,1421,1419,2,100.1409443
Iceland,1977,1435,1433,2,100.1395673
Austria,2017,83270,83154,116,100.1395002
Hungary,1971,123009,122838,171,100.1392077
Netherlands,1977,110093,109940,153,100.1391668
Slovakia,2006,53301,53227,74,100.1390272
New Zealand,1974,25254,25219,35,100.1387842
Italy,1987,532771,532034,737,100.138525
Hungary,2018,131045,130864,181,100.1383115
United Kingdom,2013,576458,575663,795,100.1381016
Canada,1951,125454,125281,173,100.1380896
France,1964,516478,515775,703,100.1362997
North Macedonia,2020,25755,25720,35,100.1360809
Netherlands,1963,95734,95604,130,100.1359776
Netherlands,1995,135675,135491,184,100.1358024
Norway,1961,33313,33268,45,100.1352651
Canada,1987,184953,184704,249,100.1348103
Netherlands,1966,100516,100381,135,100.1344876
Slovakia,2007,53856,53784,72,100.1338688
Netherlands,1965,98026,97895,131,100.1338168
Hungary,1996,143130,142939,191,100.1336234
Czechia,2014,105665,105526,139,100.1317211
Puerto Rico,1988,25117,25084,33,100.131558
Finland,1973,43410,43353,57,100.1314788
Kuwait,1977,5365,5358,7,100.1306458
Ukraine,1997,754151,753171,980,100.1301165
Norway,1976,40216,40164,52,100.1294692
Australia,1997,128695,128529,166,100.1291537
Switzerland,1953,49684,49620,64,100.1289802
Hungary,1999,143210,143026,184,100.1286479
Italy,1999,567741,567015,726,100.1280389
Switzerland,1972,56489,56417,72,100.1276211
Australia,1983,110148,110008,140,100.1272635
New Zealand,1983,26007,25974,33,100.1270501
Netherlands,1978,114415,114270,145,100.1268924
Netherlands,2013,141245,141066,179,100.126891
Norway,1987,44989,44932,57,100.1268584
Slovakia,2009,52913,52846,67,100.1267835
Finland,2016,53964,53896,68,100.1261689
Hungary,1998,140870,140693,177,100.1258058
Australia,2016,158504,158305,199,100.1257067
Netherlands,1981,115515,115370,145,100.1256826
Canada,1992,196535,196290,245,100.1248153
Italy,1953,472711,472124,587,100.1243317
Finland,1954,37988,37941,47,100.1238765
Norway,1979,41632,41581,51,100.1226522
Finland,1964,42512,42460,52,100.1224682
Switzerland,1951,49952,49891,61,100.1222665
New Zealand,1986,27052,27019,33,100.1221363
Hungary,1991,144813,144637,176,100.1216839
Ireland,1965,33022,32982,40,100.1212783
Netherlands,2004,136553,136388,165,100.1209784
France,1995,531618,530979,639,100.1203437
Austria,2014,78252,78158,94,100.1202692
Switzerland,1969,58002,57933,69,100.1191031
Italy,1984,534676,534042,634,100.1187173
Canada,2013,252338,252039,299,100.1186324
Italy,1974,532043,531413,630,100.1185519
Australia,1993,120788,120645,143,100.1185296
Switzerland,1962,55125,55060,65,100.118053
New Zealand,1965,22976,22949,27,100.1176522
United Kingdom,1962,636051,635304,747,100.1175815
Australia,1998,127358,127209,149,100.1171301
Netherlands,1970,109619,109491,128,100.1169046
Ukraine,2003,765408,764515,893,100.1168061
Norway,2013,41178,41130,48,100.1167031
Israel,1977,24951,24922,29,100.1163631
Sweden,2006,91271,91165,106,100.1162727
Italy,1971,522654,522051,603,100.115506
Australia,1990,118915,118778,137,100.1153412
Italy,1972,523828,523226,602,100.1150554
New Zealand,1955,19225,19203,22,100.1145654
Italy,1985,547436,546810,626,100.1144822
Israel,2009,38595,38551,44,100.1141345
Ireland,1964,32630,32593,37,100.1135213
Czechia,2004,107177,107056,121,100.113025
Norway,1953,28412,28380,32,100.1127555
Ireland,1961,34763,34724,39,100.1123142
Hungary,2007,132938,132789,149,100.1122081
Finland,1974,44676,44626,50,100.1120423
Switzerland,1961,51004,50947,57,100.111881
Italy,1973,547542,546931,611,100.1117143
Sweden,1971,82734,82642,92,100.1113235
Sweden,2007,91820,91718,102,100.1112104
Germany,1994,884661,883679,982,100.1111263
Hungary,1994,146889,146726,163,100.1110914
Norway,1977,39824,39780,44,100.1106083
Canada,2004,226584,226334,250,100.1104562
Canada,2005,230132,229879,253,100.1100579
Hungary,1990,145660,145500,160,100.1099656
Norway,1974,39464,39421,43,100.1090789
Italy,1955,446689,446204,485,100.1086947
Czechia,2011,106848,106732,116,100.1086834
Slovakia,2010,53445,53387,58,100.1086407
Norway,1970,38723,38681,42,100.1085804
Switzerland,2014,63863,63794,69,100.1081606
Netherlands,1991,129958,129818,140,100.1078433
New Zealand,1969,24161,24135,26,100.1077274
Switzerland,1984,58602,58539,63,100.1076206
Switzerland,1971,57856,57794,62,100.1072776
Norway,2001,43977,43930,47,100.1069884
Argentina,2009,301868,301546,322,100.106783
Italy,1986,544489,543909,580,100.1066355
Australia,2000,128784,128647,137,100.106493
Finland,1956,38713,38672,41,100.1060199
United Kingdom,1972,673938,673225,713,100.1059081
Canada,1975,167176,167000,176,100.1053892
Canada,2001,219538,219307,231,100.1053318
Slovakia,2018,54293,54236,57,100.1050962
Ukraine,1993,741664,740887,777,100.1048743
Netherlands,1980,114279,114160,119,100.1042397
Switzerland,1966,55804,55746,58,100.1040433
Italy,1952,474526,474033,493,100.1040012
Switzerland,1973,56990,56931,59,100.1036342
Sweden,1972,84051,83964,87,100.1036158
Italy,1993,552365,551794,571,100.1034806
Uruguay,2008,31068,31036,32,100.1031061
Greece,2013,111794,111679,115,100.1029737
Italy,1983,564330,563754,576,100.1021722
France,2001,531072,530533,539,100.1015959
Switzerland,2005,61124,61062,62,100.1015361
Italy,1994,556325,555765,560,100.100762
Canada,2002,223603,223378,225,100.1007261
Slovakia,1995,52683,52630,53,100.100703
Czechia,1994,117373,117255,118,100.1006354
Finland,1967,43790,43746,44,100.1005806
Netherlands,1994,133471,133337,134,100.1004972
Switzerland,2002,61768,61706,62,100.1004765
Switzerland,1957,51066,51015,51,100.0999706
Austria,1972,95323,95228,95,100.0997606
Hungary,1993,150244,150096,148,100.0986036
Sweden,1988,96756,96661,95,100.0982816
Slovakia,2003,52230,52179,51,100.0977405
Italy,1975,554346,553806,540,100.0975071
Australia,1987,118143,118028,115,100.0974345
Estonia,1988,18551,18533,18,100.097124
Hungary,1977,132031,131904,127,100.0962821
Australia,1958,83723,83643,80,100.0956446
United Kingdom,1993,658481,657852,629,100.0956142
United Kingdom,1992,634239,633640,599,100.0945332
Norway,1972,39375,39338,37,100.0940566
Switzerland,1974,56403,56350,53,100.094055
Slovakia,2016,52351,52302,49,100.0936867
Czechia,2005,107938,107837,101,100.0936599
Norway,1985,44372,44331,41,100.0924861
Hungary,1961,96410,96321,89,100.0923994
Canada,2017,276689,276434,255,100.0922463
Netherlands,2001,140377,140248,129,100.0919799
Norway,1957,30560,30532,28,100.0917071
Portugal,2018,113573,113469,104,100.091655
Czechia,2006,104441,104346,95,100.0910433
Czechia,1998,109527,109428,99,100.0904704
Finland,2010,50910,50864,46,100.0904372
Norway,1971,38981,38946,35,100.089868
Hungary,1976,132240,132122,118,100.0893114
Poland,1994,386398,386054,344,100.0891067
Belgium,1957,107840,107744,96,100.0891001
Sweden,2011,89941,89861,80,100.0890264
Switzerland,1968,57374,57323,51,100.0889695
Czechia,2007,104636,104543,93,100.0889586
Austria,2016,80669,80598,71,100.0880915
Netherlands,1964,93437,93356,81,100.0867646
Hungary,1979,136829,136711,118,100.0863135
Austria,1973,92768,92688,80,100.0863111
Switzerland,1982,59204,59153,51,100.0862171
United Kingdom,1954,578400,577903,497,100.0860006
Switzerland,1954,49113,49071,42,100.0855903
Switzerland,1965,55547,55500,47,100.0846847
Czechia,2013,109160,109068,92,100.084351
Netherlands,1974,109250,109158,92,100.0842815
Norway,1993,46623,46584,39,100.0837197
Sweden,2015,91002,90926,76,100.0835845
Czechia,2000,109001,108910,91,100.0835552
France,1965,540341,539894,447,100.082794
Norway,1975,40061,40028,33,100.0824423
United States,2008,2471984,2469957,2027,100.0820662
Austria,2010,77199,77136,63,100.0816739
Canada,1993,204912,204747,165,100.0805873
Finland,2017,53670,53627,43,100.0801835
Switzerland,2008,61233,61184,49,100.0800863
Netherlands,1993,137795,137685,110,100.0798925
Switzerland,1952,47624,47586,38,100.0798554
Austria,1967,95438,95362,76,100.0796963
Austria,1988,83263,83197,66,100.0793298
Switzerland,1985,59583,59536,47,100.0789438
Italy,1982,534935,534515,420,100.0785759
Singapore,1989,14059,14048,11,100.078303
Sweden,1954,69030,68976,54,100.0782881
Norway,2004,41257,41225,32,100.0776228
New Zealand,2005,27141,27120,21,100.0774336
Switzerland,1989,60882,60835,47,100.0772582
Slovakia,2004,51852,51812,40,100.0772022
Sweden,2018,92250,92179,71,100.0770241
New Zealand,1972,24793,24774,19,100.0766933
Norway,1965,35317,35290,27,100.0765089
France,2006,515952,515558,394,100.0764221
Norway,1963,36850,36822,28,100.0760415
Hungary,2009,130414,130315,99,100.0759698
Finland,2007,49093,49056,37,100.075424
Iceland,1963,1327,1326,1,100.0754148
Netherlands,1967,99792,99717,75,100.0752129
United Kingdom,2017,606049,605595,454,100.0749676
Netherlands,1992,129887,129790,97,100.0747361
France,1963,554315,553908,407,100.0734779
Canada,2009,238418,238243,175,100.0734544
Austria,1971,97334,97263,71,100.072998
Canada,1994,207077,206927,150,100.0724893
United Kingdom,1974,667359,666878,481,100.0721271
Austria,1969,98715,98644,71,100.071976
Ukraine,1999,739170,738639,531,100.071889
Canada,1989,190965,190828,137,100.0717924
Portugal,1966,100088,100017,71,100.0709879
Italy,1970,521096,520728,368,100.0706703
Canada,1981,171029,170909,120,100.0702128
New Zealand,1964,22861,22845,16,100.0700372
Switzerland,1956,51573,51537,36,100.0698527
United Kingdom,1961,631788,631348,440,100.0696922
Finland,1959,38827,38800,27,100.0695876
Hungary,1978,140121,140024,97,100.0692738
Slovakia,2017,53914,53877,37,100.0686749
Slovakia,1996,51236,51201,35,100.068358
Norway,1964,35171,35147,24,100.0682846
Austria,2005,75189,75138,51,100.0678751
Iceland,1979,1482,1481,1,100.0675219
Portugal,1956,106919,106847,72,100.0673861
Czechia,2003,111288,111214,74,100.0665384
Canada,2014,258821,258649,172,100.0664994
Sweden,1958,71065,71018,47,100.0661804
Austria,1997,79432,79380,52,100.0655077
Norway,2010,41442,41415,27,100.0651938
Iceland,1980,1538,1537,1,100.0650618
Finland,1990,50087,50055,32,100.0639297
Ukraine,1991,669957,669529,428,100.0639255
Hungary,2006,131603,131519,84,100.0638691
United Kingdom,1953,577220,576852,368,100.0637945
Austria,1965,94273,94213,60,100.0636855
New Zealand,1962,22081,22067,14,100.0634432
Belgium,2011,104292,104226,66,100.0633239
Czechia,2001,107755,107687,68,100.063146
Austria,1970,98819,98757,62,100.0627804
Slovakia,1993,52707,52674,33,100.0626495
Canada,1978,168179,168074,105,100.0624725
Canada,2003,226169,226028,141,100.0623817
Austria,1993,82517,82466,51,100.0618437
Finland,1961,40616,40591,25,100.06159
United Kingdom,2014,570341,569990,351,100.06158
Austria,2015,83073,83022,51,100.0614295
Sweden,1978,89669,89614,55,100.0613743
Hungary,1975,131102,131022,80,100.0610584
Finland,1965,44473,44446,27,100.0607479
Ukraine,1998,719954,719518,436,100.0605961
United Kingdom,1955,595916,595556,360,100.0604477
Finland,1966,43548,43522,26,100.0597399
Switzerland,1964,53609,53577,32,100.0597271
Australia,1988,118965,118894,71,100.0597171
Czechia,1989,127747,127671,76,100.059528
Finland,1997,49143,49114,29,100.0590463
Austria,1989,83407,83358,49,100.0587826
Iceland,1987,1724,1723,1,100.0580383
Switzerland,1959,50077,50048,29,100.0579444
Finland,2001,48504,48476,28,100.0577605
Ukraine,1981,568789,568461,328,100.0576996
Sweden,2009,90177,90125,52,100.0576976
Germany,1995,884588,884079,509,100.057574
Sweden,2002,95071,95017,54,100.0568319
Austria,1986,87071,87022,49,100.0563076
Netherlands,1968,104989,104930,59,100.056228
Uruguay,1985,28557,28541,16,100.0560597
Hungary,2005,135732,135656,76,100.0560241
Norway,2006,41242,41219,23,100.0557995
Iceland,1991,1796,1795,1,100.0557103
Finland,1998,49237,49210,27,100.0548669
Switzerland,2006,60283,60250,33,100.0547718
Denmark,1959,42159,42136,23,100.0545852
Slovakia,1994,51383,51355,28,100.0545224
Sweden,1956,70205,70167,38,100.0541565
France,1993,532263,531976,287,100.0539498
Austria,1976,95140,95089,51,100.053634
France,1991,524685,524406,279,100.0532031
Italy,1962,509174,508904,270,100.0530552
Austria,2009,77381,77340,41,100.0530127
Estonia,2007,17409,17400,9,100.0517241
Hungary,2008,130027,129960,67,100.0515543
Italy,1964,490050,489800,250,100.0510412
Australia,1986,114337,114280,57,100.0498775
France,1994,519965,519707,258,100.0496434
New Zealand,1963,22416,22405,11,100.0490962
Canada,2015,264333,264204,129,100.0488259
Switzerland,1977,55658,55631,27,100.0485341
Hungary,1970,120197,120139,58,100.0482774
Czechia,1988,125694,125634,60,100.0477578
Czechia,1993,118185,118129,56,100.0474058
Sweden,1951,69799,69766,33,100.047301
Canada,2008,238617,238506,111,100.0465397
United Kingdom,1975,662477,662172,305,100.0460605
Switzerland,1980,59097,59070,27,100.0457085
Italy,1992,546690,546441,249,100.0455676
France,2002,535140,534900,240,100.0448682
United Kingdom,1967,616710,616434,276,100.0447736
United Kingdom,1969,659537,659242,295,100.0447484
Netherlands,1982,117264,117212,52,100.0443641
Hungary,2000,135601,135541,60,100.044267
Switzerland,2001,61283,61256,27,100.0440773
Netherlands,2012,140813,140752,61,100.0433386
Slovakia,2005,53475,53452,23,100.0430293
Australia,1991,118520,118470,50,100.0422048
Slovakia,2012,52437,52415,22,100.0419727
Hungary,2012,129440,129387,53,100.0409624
Poland,1999,381415,381260,155,100.0406547
Austria,1974,94324,94286,38,100.0403029
Ukraine,2010,698235,697954,281,100.0402605
Norway,1992,44736,44718,18,100.0402522
United States,2014,2626418,2625365,1053,100.0401087
Austria,1977,92402,92365,37,100.0400585
Hungary,2016,127053,127004,49,100.0385815
Norway,1981,41893,41877,16,100.0382071
Austria,1981,92693,92658,35,100.0377733
Canada,1996,212859,212779,80,100.0375977
Hungary,1969,116659,116616,43,100.0368732
Switzerland,1991,62634,62611,23,100.0367348
Ukraine,2011,664588,664347,241,100.0362762
Netherlands,2011,135741,135692,49,100.0361112
United Kingdom,1971,645078,644846,232,100.0359776
Czechia,2017,111443,111403,40,100.0359057
Belgium,1955,108743,108704,39,100.0358772
Canada,1983,174484,174422,62,100.035546
New Zealand,1996,28379,28369,10,100.0352497
Switzerland,2000,62545,62523,22,100.0351871
Switzerland,1970,57091,57071,20,100.0350441
Germany,2005,830227,829939,288,100.0347013
Slovakia,2001,51980,51962,18,100.0346407
United Kingdom,1952,573806,573608,198,100.0345183
Canada,2006,228079,228001,78,100.0342104
Hungary,1962,108273,108236,37,100.0341846
Ukraine,2012,663139,662913,226,100.034092
Norway,1980,41340,41326,14,100.033877
Netherlands,2005,136402,136356,46,100.0337352
Hungary,1988,140042,139996,46,100.0328581
Estonia,1987,18279,18273,6,100.0328353
Finland,1962,42889,42875,14,100.0326531
Czechia,1996,112782,112746,36,100.0319302
Hungary,2001,132183,132141,42,100.0317842
Italy,1956,497550,497394,156,100.0313635
Switzerland,1988,60648,60629,19,100.0313381
Canada,1990,191973,191913,60,100.0312642
Canada,2018,283706,283619,87,100.030675
Sweden,1968,82532,82507,25,100.0303005
Sweden,1953,69553,69532,21,100.0302019
France,1975,560373,560204,169,100.0301676
Austria,1963,91579,91552,27,100.0294914
Netherlands,1979,112565,112533,32,100.0284361
Norway,1984,42581,42569,12,100.0281895
Hungary,2015,131697,131660,37,100.0281027
Finland,2009,49904,49890,14,100.0280617
Italy,1961,468455,468326,129,100.0275449
Canada,2019,284082,284005,77,100.0271122
Canada,1995,210733,210676,57,100.0270558
Czechia,1987,127244,127210,34,100.0267275
Poland,1995,386084,385982,102,100.0264261
Portugal,1965,95187,95163,24,100.0252199
Belgium,2012,109076,109049,27,100.0247595
Hungary,2017,131674,131642,32,100.0243084
Netherlands,2007,133022,132990,32,100.024062
Italy,1957,484190,484075,115,100.0237566
Poland,2001,363220,363134,86,100.0236827
Sweden,1973,85632,85612,20,100.0233612
Canada,1999,219530,219479,51,100.0232368
Hungary,1973,123366,123338,28,100.0227018
Belarus,1997,136653,136624,29,100.0212261
France,2007,520535,520425,110,100.0211366
Netherlands,1998,137482,137453,29,100.0210981
Hungary,1960,101525,101504,21,100.0206888
Italy,1958,457690,457597,93,100.0203236
Australia,1995,125106,125081,25,100.019987
Switzerland,2004,60180,60168,12,100.0199442
Czechia,1986,132588,132563,25,100.018859
Canada,1998,218091,218050,41,100.018803
Italy,1980,554510,554407,103,100.0185784
Netherlands,1988,124163,124140,23,100.0185275
Austria,2002,76131,76117,14,100.0183927
Finland,1999,49368,49359,9,100.0182338
Sweden,2001,93808,93791,17,100.0181254
United Kingdom,1970,655385,655267,118,100.0180079
Norway,1999,45114,45106,8,100.017736
United Kingdom,1959,606115,606008,107,100.0176565
Czechia,1999,109768,109749,19,100.0173122
United Kingdom,1990,641799,641688,111,100.0172981
Norway,1982,41454,41447,7,100.016889
Czechia,1997,112744,112725,19,100.0168552
North Macedonia,2005,18406,18403,3,100.0163017
Norway,2000,44018,44011,7,100.0159051
Hungary,1989,144695,144672,23,100.015898
Sweden,1990,95142,95127,15,100.0157684
New Zealand,1982,25547,25543,4,100.0156599
Finland,1955,39573,39567,6,100.0151642
Switzerland,1981,59763,59754,9,100.0150618
New Zealand,1985,27484,27480,4,100.014556
Austria,1990,82952,82940,12,100.0144683
Hungary,2003,135823,135804,19,100.0139908
Canada,1986,184224,184199,25,100.0135723
Czechia,1990,129166,129149,17,100.0131631
Canada,1988,190011,189986,25,100.0131589
Austria,1979,92012,92001,11,100.0119564
Slovakia,2013,52084,52078,6,100.0115212
Austria,1999,78200,78191,9,100.0115103
Finland,2014,52409,52403,6,100.0114497
Finland,1975,43853,43848,5,100.011403
Finland,1970,44119,44114,5,100.0113343
Austria,1996,80790,80781,9,100.0111412
Sweden,1980,91795,91785,10,100.010895
Czechia,2015,111173,111161,12,100.0107952
United States,2009,2437944,2437684,260,100.0106659
Sweden,1960,75093,75085,8,100.0106546
Denmark,1951,37959,37955,4,100.0105388
Austria,2011,76479,76471,8,100.0104615
Austria,1968,96014,96004,10,100.0104162
New Zealand,1956,19696,19694,2,100.0101554
Norway,2009,41342,41338,4,100.0096763
Mauritius,2018,10787,10786,1,100.0092713
Hungary,1980,145355,145342,13,100.0089444
Canada,1985,181323,181307,16,100.0088248
Austria,1983,93041,93033,8,100.0085991
Switzerland,1992,62302,62297,5,100.0080261
Switzerland,1997,62880,62875,5,100.0079523
New Zealand,1989,27044,27042,2,100.0073959
France,1992,521530,521492,38,100.0072868
Ukraine,2001,745952,745899,53,100.0071055
Canada,1984,175727,175715,12,100.0068292
New Zealand,1954,18876,18875,1,100.005298
Serbia,2008,102711,102706,5,100.0048683
Switzerland,1995,63389,63386,3,100.0047329
Hungary,2002,132833,132827,6,100.0045172
Sweden,1983,90783,90779,4,100.0044063
Netherlands,1969,107615,107612,3,100.0027878
Austria,2004,74292,74290,2,100.0026922
Norway,1978,40682,40681,1,100.0024581
Sweden,1984,90467,90465,2,100.0022108
Switzerland,1960,52094,52093,1,100.0019196
France,1996,535775,535766,9,100.0016798
Netherlands,2006,135372,135370,2,100.0014774
Sweden,1989,92094,92093,1,100.0010859
United Kingdom,1991,646181,646175,6,100.0009285
Netherlands,2000,140527,140526,1,100.0007116
Antigua and Barbuda,2007,484,484,0,100
Fiji,2007,6310,6310,0,100
French Guiana,1969,419,419,0,100
French Guiana,1971,419,419,0,100
Grenada,1988,756,756,0,100
Grenada,1989,747,747,0,100
Iceland,1985,1654,1654,0,100
Iceland,1984,1584,1584,0,100
Iceland,1993,1753,1753,0,100
Iceland,2000,1828,1828,0,100
Iceland,2002,1822,1822,0,100
Netherlands,1989,128905,128905,0,100
New Zealand,1970,24840,24840,0,100
Saint Kitts and Nevis,1989,505,505,0,100
Canada,1982,174413,174414,-1,99.99942665
Sweden,1979,91060,91061,-1,99.99890184
Austria,1987,84907,84908,-1,99.99882225
Switzerland,2010,62649,62650,-1,99.99840383
United Kingdom,1976,680798,680810,-12,99.99823739
Finland,1994,47938,47939,-1,99.99791402
Denmark,1964,46811,46812,-1,99.9978638
Canada,1997,215668,215673,-5,99.99768168
Norway,2012,41913,41914,-1,99.99761416
Czechia,1992,120337,120340,-3,99.99750706
Finland,1952,39024,39025,-1,99.99743754
Canada,1991,195568,195574,-6,99.99693211
Austria,2012,79436,79439,-3,99.99622352
Netherlands,2008,135136,135142,-6,99.99556023
Sweden,1975,88202,88206,-4,99.99546516
Germany,2002,841686,841727,-41,99.99512906
Slovenia,1993,20012,20013,-1,99.99500325
Hungary,1972,118991,118997,-6,99.99495786
Italy,1959,454740,454767,-27,99.99406289
Italy,1960,480932,480963,-31,99.9935546
Belgium,1973,118254,118262,-8,99.99323536
Norway,1983,42224,42227,-3,99.99289554
New Zealand,2003,28061,28063,-2,99.99287318
New Zealand,1976,25450,25452,-2,99.99214207
Finland,2011,50568,50572,-4,99.99209048
Austria,1984,88466,88473,-7,99.99208798
Poland,2002,359486,359515,-29,99.99193358
Sweden,1981,92030,92038,-8,99.99130794
Switzerland,2019,67780,67786,-6,99.99114861
Slovakia,1997,52124,52129,-5,99.99040841
Austria,1992,83162,83170,-8,99.99038115
Austria,1962,90854,90863,-9,99.99009498
United Kingdom,1968,655998,656064,-66,99.98994001
Switzerland,1979,57454,57460,-6,99.98955795
Czechia,1991,124290,124304,-14,99.98873729
Netherlands,2009,134235,134251,-16,99.98808203
France,1989,529283,529352,-69,99.9869652
Slovakia,1998,53156,53163,-7,99.98683295
Netherlands,1990,128824,128841,-17,99.98680544
Ireland,1959,34243,34248,-5,99.98540061
Netherlands,2010,136058,136078,-20,99.98530255
Austria,2006,74295,74306,-11,99.98519635
Switzerland,1986,60105,60114,-9,99.98502845
Sweden,1970,80023,80035,-12,99.98500656
France,1966,525497,525576,-79,99.98496887
Austria,1991,83428,83441,-13,99.98442013
Hungary,1965,108119,108136,-17,99.98427906
New Zealand,1975,25115,25119,-4,99.9840758
Norway,1990,46041,46049,-8,99.9826272
Kuwait,2011,5339,5340,-1,99.98127341
Denmark,1954,39885,39893,-8,99.97994636
Hungary,1964,100830,100851,-21,99.9791772
Ukraine,1990,629602,629736,-134,99.97872124
Germany,2007,827155,827341,-186,99.97751834
Netherlands,2002,142355,142388,-33,99.97682389
Sweden,1977,88184,88205,-21,99.97619183
Luxembourg,1970,4156,4157,-1,99.97594419
Luxembourg,1980,4134,4135,-1,99.9758162
Belgium,1954,105033,105059,-26,99.975252
Austria,1966,91440,91463,-23,99.97485322
United States,2010,2469288,2469925,-637,99.97420974
Poland,1996,385496,385597,-101,99.97380685
France,2012,558452,558599,-147,99.97368416
Sweden,1952,68270,68288,-18,99.97364105
Belgium,1956,108761,108790,-29,99.97334314
Switzerland,1990,63739,63756,-17,99.97333584
New Zealand,1977,25966,25973,-7,99.97304894
Austria,1995,81171,81193,-22,99.97290407
Belgium,1961,106985,107014,-29,99.97290074
Switzerland,1993,62512,62529,-17,99.97281261
Germany,2003,853946,854182,-236,99.97237123
Finland,1960,39797,39808,-11,99.97236736
Hungary,2004,132492,132529,-37,99.97208158
New Zealand,1959,21128,21134,-6,99.97160973
Austria,1980,92442,92469,-27,99.97080103
Sweden,1965,78194,78217,-23,99.97059463
Hungary,1987,142601,142644,-43,99.96985502
Denmark,1962,45334,45348,-14,99.96912764
Austria,1994,80684,80709,-25,99.96902452
Switzerland,2003,63070,63090,-20,99.96829926
Australia,1976,112662,112698,-36,99.96805622
Italy,1978,540671,540847,-176,99.96745845
Finland,2008,49090,49106,-16,99.96741742
Germany,2006,821627,821895,-268,99.96739243
Canada,1977,167498,167553,-55,99.96717457
Norway,1995,45182,45197,-15,99.96681196
Belgium,2014,104755,104790,-35,99.96659987
Ukraine,2000,758082,758336,-254,99.96650561
Belgium,1974,116159,116198,-39,99.9664366
Malta,1967,2944,2945,-1,99.96604414
Italy,1981,545291,545479,-188,99.96553488
Denmark,1961,43310,43325,-15,99.96537796
Belgium,1967,115212,115252,-40,99.96529344
Hungary,1986,147089,147141,-52,99.96465975
Denmark,1967,47836,47853,-17,99.96447454
Austria,1964,89081,89113,-32,99.96409054
Slovakia,2000,52724,52743,-19,99.96397626
Guadeloupe,2007,2770,2771,-1,99.96391195
Canada,2007,235217,235302,-85,99.96387621
Italy,1968,532571,532764,-193,99.96377383
Hungary,1982,144318,144371,-53,99.96328903
Switzerland,1963,56989,57010,-21,99.96316436
Switzerland,2017,66971,66996,-25,99.96268434
Italy,1963,516377,516570,-193,99.96263817
Netherlands,1987,122199,122245,-46,99.96237065
Netherlands,1999,140487,140540,-53,99.96228832
United Kingdom,1977,655143,655391,-248,99.96215999
Hungary,1981,144757,144812,-55,99.96201972
Sweden,1961,73555,73583,-28,99.96194773
Belgium,1977,112672,112715,-43,99.96185069
Germany,1997,860389,860730,-341,99.96038247
United Kingdom,1956,597981,598223,-242,99.95954686
Denmark,1958,41560,41577,-17,99.95911201
Netherlands,2014,139223,139280,-57,99.95907524
Switzerland,1975,55924,55947,-23,99.95888966
Switzerland,2015,67606,67634,-28,99.9586007
Australia,2018,158658,158724,-66,99.95841839
Slovakia,1999,52402,52424,-22,99.95803449
Estonia,1996,19020,19028,-8,99.9579567
Denmark,1968,47290,47310,-20,99.95772564
New Zealand,1960,20892,20901,-9,99.95693986
New Zealand,1957,20862,20871,-9,99.95687796
Poland,2010,378478,378642,-164,99.95668732
Hungary,1968,115354,115404,-50,99.95667395
United Kingdom,1980,661519,661807,-288,99.95648278
Hungary,2014,126308,126363,-55,99.9564746
Australia,2004,132314,132372,-58,99.95618409
United Kingdom,1958,604040,604311,-271,99.95515554
France,1977,536221,536462,-241,99.95507604
Australia,2001,128657,128715,-58,99.95493921
Hungary,1983,148643,148711,-68,99.95427373
Iceland,2015,2182,2183,-1,99.95419148
New Zealand,1961,21782,21792,-10,99.9541116
Sweden,1987,93315,93358,-43,99.95394074
Belgium,1959,103933,103981,-48,99.95383772
Estonia,2006,17316,17324,-8,99.95382129
Bulgaria,1965,66970,67001,-31,99.95373203
Switzerland,1998,62567,62596,-29,99.95367116
Canada,1979,168183,168261,-78,99.95364345
Finland,2002,49389,49412,-23,99.9534526
Belgium,1972,117424,117479,-55,99.95318312
South Korea,2009,246942,247059,-117,99.95264289
Hungary,1984,146709,146779,-70,99.95230925
Ukraine,1992,697106,697439,-333,99.95225389
Ukraine,1986,565150,565421,-271,99.95207111
Ireland,1960,32660,32676,-16,99.9510344
France,1997,530319,530579,-260,99.95099693
Estonia,2003,18152,18161,-9,99.95044326
Italy,1979,538352,538619,-267,99.95042878
Netherlands,1985,122704,122765,-61,99.95031157
Netherlands,1984,119812,119873,-61,99.94911281
Germany,2016,910899,911364,-465,99.94897758
Germany,2010,858768,859207,-439,99.94890638
Georgia,2013,48553,48578,-25,99.94853637
Austria,1957,89298,89344,-46,99.94851361
Denmark,1955,38791,38811,-20,99.94846822
Slovenia,2019,20588,20599,-11,99.94659935
Ukraine,1989,600590,600912,-322,99.94641478
Poland,2005,368285,368483,-198,99.94626618
Slovakia,1992,53423,53452,-29,99.94574572
Australia,1989,125238,125306,-68,99.94573285
France,1988,524600,524888,-288,99.94513115
United Kingdom,1960,603328,603662,-334,99.94467102
Belgium,1958,106051,106110,-59,99.94439732
Switzerland,2007,61089,61123,-34,99.94437446
Hungary,1966,101943,102000,-57,99.94411765
United Kingdom,1957,591200,591536,-336,99.94319872
France,1980,547107,547419,-312,99.94300527
Slovenia,2020,24016,24030,-14,99.94173949
Sweden,1976,90671,90724,-53,99.94158106
Germany,2001,828541,829034,-493,99.9405332
Iceland,1983,1653,1654,-1,99.93954051
Denmark,1953,39350,39374,-24,99.93904607
Belgium,2016,108097,108163,-66,99.93898098
Ukraine,1988,600725,601093,-368,99.93877819
Ukraine,1985,617548,617927,-379,99.93866589
Austria,1960,89603,89658,-55,99.93865578
Russia,1994,2301366,2302824,-1458,99.93668643
Switzerland,1987,59511,59549,-38,99.93618701
Austria,1985,89578,89636,-58,99.93529386
Finland,2019,53962,53997,-35,99.93518158
Canada,1957,136579,136669,-90,99.93414747
Finland,1968,45013,45043,-30,99.93339698
Netherlands,1983,117761,117840,-79,99.93295995
France,2000,530850,531207,-357,99.93279456
Switzerland,1983,60756,60797,-41,99.93256246
Austria,1975,96041,96106,-65,99.93236635
Iceland,1973,1475,1476,-1,99.93224932
France,1990,526201,526560,-359,99.93182163
Sweden,1974,86305,86364,-59,99.9316845
Puerto Rico,2001,29082,29102,-20,99.9312762
Netherlands,2015,147134,147236,-102,99.93072346
France,1998,534003,534376,-373,99.93019896
Ukraine,1982,568231,568629,-398,99.93000709
Hungary,1963,99871,99942,-71,99.9289588
Iceland,1967,1385,1386,-1,99.92784993
Austria,2000,76780,76836,-56,99.9271175
Netherlands,2016,148997,149107,-110,99.92622747
Netherlands,2017,150214,150325,-111,99.92615999
Australia,1969,106496,106575,-79,99.9258738
Germany,2008,844439,845069,-630,99.92544987
Germany,2011,852328,852964,-636,99.92543648
Germany,1996,882843,883503,-660,99.92529737
United Kingdom,1981,657974,658468,-494,99.92497737
Australia,1999,128079,128176,-97,99.92432281
Switzerland,1978,57718,57762,-44,99.92382535
Belgium,1987,105426,105507,-81,99.92322784
Poland,2000,368028,368313,-285,99.92262016
Belgium,2013,109334,109419,-85,99.92231697
New Zealand,1967,23007,23025,-18,99.9218241
United Kingdom,1979,675577,676110,-533,99.92116667
Poland,2007,377226,377524,-298,99.92106462
Norway,1955,29099,29122,-23,99.92102191
Denmark,1957,41730,41763,-33,99.92098269
Denmark,1969,47943,47981,-38,99.92080198
United States,2013,2596993,2599058,-2065,99.92054814
Belgium,1994,103778,103861,-83,99.9200855
France,1979,541805,542240,-435,99.91977722
Sweden,1966,78440,78503,-63,99.91974829
Austria,1978,94617,94693,-76,99.91974064
Singapore,1988,13689,13700,-11,99.91970803
Belgium,1960,113938,114030,-92,99.91931948
Denmark,1956,39590,39622,-32,99.91923679
Ukraine,1987,586387,586867,-480,99.91820975
Netherlands,1997,135783,135895,-112,99.91758343
Portugal,1962,96864,96945,-81,99.91644747
Austria,1961,85673,85746,-73,99.91486483
Hungary,1956,104236,104326,-90,99.91373196
Israel,1994,33535,33564,-29,99.9135979
Israel,2008,39241,39275,-34,99.91343094
Switzerland,1994,61987,62041,-54,99.91296078
Sweden,1982,90666,90745,-79,99.91294286
Iceland,1951,1145,1146,-1,99.91273997
Poland,2004,363522,363844,-322,99.91150053
Norway,1994,44076,44116,-40,99.90932995
Denmark,1972,50445,50491,-46,99.90889465
Finland,2000,49316,49361,-45,99.90883491
Austria,1958,85980,86059,-79,99.90820251
France,1982,543104,543604,-500,99.90802128
Sweden,1986,93268,93354,-86,99.90787754
France,1978,546916,547422,-506,99.90756674
Sweden,2010,90519,90603,-84,99.90728784
Belgium,1975,119425,119536,-111,99.90714094
United Kingdom,1989,657733,658347,-614,99.90673611
Denmark,1965,47884,47929,-45,99.90611112
Iceland,1954,1064,1065,-1,99.90610329
Sweden,1967,79783,79858,-75,99.9060833
Netherlands,1986,125307,125426,-119,99.90512334
Luxembourg,1978,4183,4187,-4,99.9044662
Germany,2004,818271,819054,-783,99.90440191
Germany,1998,852382,853210,-828,99.90295472
France,1983,559655,560199,-544,99.90289165
Austria,2008,75083,75156,-73,99.9028687
Canada,1974,166794,166958,-164,99.9017717
New Zealand,1979,25373,25398,-25,99.90156705
France,1967,539946,540479,-533,99.90138377
France,1987,527466,527988,-522,99.90113412
Ukraine,1994,764669,765430,-761,99.90057876
Belgium,1962,112758,112871,-113,99.89988571
France,1981,554823,555382,-559,99.89934856
Estonia,1991,19715,19735,-20,99.89865721
Sweden,1962,76791,76869,-78,99.89852867
Sweden,1955,68634,68704,-70,99.89811365
Portugal,1959,97754,97855,-101,99.89678606
Belgium,1971,119471,119595,-124,99.89631674
Belgium,1969,120471,120597,-126,99.89551979
Germany,2012,869582,870496,-914,99.89500239
Hungary,1985,147614,147770,-156,99.89443053
Germany,2000,838797,839691,-894,99.89353226
Norway,2014,40344,40387,-43,99.8935301
United Kingdom,1978,667177,667889,-712,99.89339546
Estonia,2008,16675,16693,-18,99.89217037
Belgium,1979,112010,112131,-121,99.8920905
Iceland,1997,1843,1845,-2,99.89159892
France,1984,542490,543080,-590,99.89136039
Netherlands,1996,137561,137711,-150,99.89107624
Australia,2003,131784,131930,-146,99.88933525
United Kingdom,1988,649178,649898,-720,99.88921338
Hungary,1967,109530,109652,-122,99.88873892
Sweden,1969,83306,83399,-93,99.88848787
Australia,2002,133047,133196,-149,99.88813478
Sweden,1985,94013,94119,-106,99.88737662
Portugal,1964,96878,96988,-110,99.88658391
Poland,2008,379399,379836,-437,99.88495035
Norway,2016,40609,40656,-47,99.88439591
Iceland,2001,1725,1727,-2,99.88419224
Slovakia,2014,51345,51405,-60,99.88327984
Poland,2009,384940,385395,-455,99.88193931
Thailand,1999,362607,363039,-432,99.88100452
France,1999,537459,538102,-643,99.88050593
Estonia,2010,15781,15800,-19,99.87974684
Poland,2003,365230,365672,-442,99.87912665
Sweden,1964,76661,76754,-93,99.87883368
Belgium,1978,115388,115529,-141,99.87795272
New Zealand,1987,27430,27464,-34,99.87620157
Israel,2004,37757,37804,-47,99.87567453
Belgium,1968,121744,121896,-152,99.87530354
United States,2012,2543279,2546455,-3176,99.87527759
Netherlands,2019,151885,152075,-190,99.87506165
Sweden,1996,93815,93933,-118,99.87437855
France,1985,552496,553196,-700,99.87346257
Portugal,1961,99590,99717,-127,99.87263957
Germany,2017,932272,933472,-1200,99.87144767
Belgium,1966,115613,115762,-149,99.87128764
Iceland,2016,2310,2313,-3,99.87029831
Israel,2003,38359,38409,-50,99.86982218
Norway,2002,44401,44459,-58,99.86954272
Poland,2011,375501,375993,-492,99.8691465
Australia,1967,102703,102838,-135,99.86872557
United States,2011,2515458,2518766,-3308,99.86866585
Italy,1954,441897,442479,-582,99.86846833
Austria,1982,91339,91460,-121,99.86770173
Ireland,1950,37741,37791,-50,99.86769337
Denmark,1960,43681,43740,-59,99.86511203
Estonia,2012,15473,15494,-21,99.86446366
France,1976,557114,557885,-771,99.86179947
Germany,1999,846330,847514,-1184,99.86029729
Germany,2009,854544,855741,-1197,99.86012123
Denmark,1994,61099,61185,-86,99.85944267
United Kingdom,2018,614690,615560,-870,99.85866528
Norway,2005,41152,41211,-59,99.85683434
Czechia,2016,107750,107905,-155,99.85635513
Iceland,1968,1387,1389,-2,99.85601152
Austria,1959,87970,88098,-128,99.85470726
Germany,2015,925200,926561,-1361,99.85311275
Germany,2013,893825,895142,-1317,99.85287251
Belgium,1965,115045,115216,-171,99.85158311
Denmark,1980,55939,56023,-84,99.85006158
Switzerland,1976,57095,57181,-86,99.84960039
New Zealand,1997,27611,27653,-42,99.84811774
Sweden,2005,91775,91915,-140,99.84768536
Italy,2017,650614,651610,-996,99.84714783
Poland,2006,369686,370252,-566,99.84713114
Netherlands,2018,153363,153598,-235,99.84700322
Poland,2015,394921,395527,-606,99.84678669
Belgium,1964,110100,110269,-169,99.84673843
Austria,2019,83386,83514,-128,99.84673228
Poland,2012,384788,385382,-594,99.84586722
Iceland,2007,1943,1946,-3,99.84583762
Switzerland,1996,62643,62741,-98,99.8438023
Iceland,2006,1903,1906,-3,99.84260231
Denmark,1971,48858,48936,-78,99.84060814
Denmark,1966,49344,49423,-79,99.84015539
Iceland,1961,1248,1250,-2,99.84
New Zealand,1978,24678,24718,-40,99.83817461
Israel,1985,28029,28075,-46,99.83615316
Poland,2016,388009,388657,-648,99.83327201
New Zealand,1981,25147,25189,-42,99.83326055
Luxembourg,1969,4178,4185,-7,99.83273596
Switzerland,2013,64961,65070,-109,99.83248809
Portugal,1967,95816,95978,-162,99.83121132
Maldives,2015,1165,1167,-2,99.82862039
Iceland,1994,1717,1720,-3,99.8255814
Malta,1986,2861,2866,-5,99.82554082
France,1962,537714,538654,-940,99.82549095
France,2009,537197,538147,-950,99.82346831
Portugal,1958,91891,92054,-163,99.82293002
Austria,1955,84995,85146,-151,99.82265755
Belgium,1995,104897,105084,-187,99.82204712
Denmark,1963,45773,45855,-82,99.82117544
Norway,2011,41304,41378,-74,99.821161
Norway,2015,40686,40759,-73,99.82089845
France,1986,546926,547931,-1005,99.81658274
Denmark,1970,48233,48322,-89,99.81581888
New Zealand,1984,25383,25430,-47,99.81517892
Austria,1956,86824,86988,-164,99.81146825
France,2016,579488,580585,-1097,99.81105265
Belgium,2017,109666,109875,-209,99.80978385
Denmark,1952,39174,39249,-75,99.80891233
Belgium,1970,118660,118888,-228,99.80822287
Belgium,1993,106824,107035,-211,99.80286822
Sweden,1963,76460,76613,-153,99.80029499
United Kingdom,1986,660735,662066,-1331,99.79896264
Portugal,1968,94661,94852,-191,99.79863366
United Kingdom,1982,662802,664142,-1340,99.79823592
Belgium,1990,104130,104342,-212,99.79682199
Grenada,2019,981,983,-2,99.7965412
Poland,2018,414200,415046,-846,99.79616717
Belgium,1989,107336,107556,-220,99.79545539
Iceland,1970,1457,1460,-3,99.79452055
United Kingdom,1983,659101,660461,-1360,99.79408322
Belgium,2010,105152,105369,-217,99.79405708
Sweden,1994,91450,91639,-189,99.79375593
United Kingdom,1987,644342,645678,-1336,99.79308572
Belgium,1992,104200,104419,-219,99.79026805
Sweden,1993,96659,96863,-204,99.78939327
Iceland,1975,1412,1415,-3,99.78798587
Belgium,2018,110693,110929,-236,99.7872513
Estonia,1992,20126,20169,-43,99.78680153
Australia,1978,108425,108659,-234,99.78464738
Uruguay,2006,30576,30642,-66,99.78460936
Ukraine,2015,594796,596083,-1287,99.78409047
Sweden,1991,94936,95144,-208,99.78138401
Switzerland,2009,62431,62568,-137,99.78103823
Switzerland,1999,62499,62637,-138,99.77968294
France,1974,550878,552097,-1219,99.77920547
Ireland,1957,34311,34387,-76,99.77898624
Belgium,1991,104149,104380,-231,99.77869324
Sweden,1995,93641,93849,-208,99.77836738
United Kingdom,1984,644918,646352,-1434,99.77813947
Austria,2018,83975,84162,-187,99.77780946
Poland,2013,387312,388176,-864,99.77742055
France,1969,570601,571883,-1282,99.77582827
United Kingdom,1985,670656,672170,-1514,99.77475936
Estonia,2004,17685,17725,-40,99.77433004
Netherlands,1959,85752,85946,-194,99.77427687
Ireland,1958,34248,34327,-79,99.76986046
Iceland,1965,1291,1294,-3,99.76816074
South Korea,2008,246113,246689,-576,99.76650763
Poland,1993,390874,391790,-916,99.76620128
Australia,2014,153580,153941,-361,99.76549457
Bulgaria,1964,64479,64633,-154,99.76173162
Slovenia,2018,20485,20534,-49,99.76137138
South Korea,2010,255405,256016,-611,99.76134304
Poland,2014,376467,377375,-908,99.75939053
New Zealand,1971,24309,24368,-59,99.75787919
Australia,1979,106568,106828,-260,99.75661812
Belgium,1988,104577,104840,-263,99.74914155
Belgium,1976,118641,118940,-299,99.74861275
Belgium,1963,116718,117013,-295,99.74789126
Greece,2012,116668,116966,-298,99.74522511
Argentina,1996,266216,266915,-699,99.73811888
South Korea,2007,246482,247132,-650,99.73698267
Malta,1989,2637,2644,-7,99.73524962
New Zealand,1968,24464,24529,-65,99.73500754
France,1968,550492,551975,-1483,99.73132841
Portugal,1955,99472,99740,-268,99.73130138
Belgium,1997,103800,104080,-280,99.73097617
Poland,2019,409709,410825,-1116,99.72835149
Belgium,2015,110541,110843,-302,99.72754256
Belgium,1985,111612,111917,-305,99.72747661
New Zealand,1988,27407,27482,-75,99.7270941
Slovenia,1992,19333,19386,-53,99.72660683
Poland,2017,402852,403958,-1106,99.72620916
Canada,1952,125950,126299,-349,99.7236716
Netherlands,1951,77194,77412,-218,99.71838991
Netherlands,1962,93558,93824,-266,99.71649045
Iceland,1966,1391,1395,-4,99.71326165
Switzerland,2018,67088,67281,-193,99.71314338
Iceland,1992,1719,1724,-5,99.7099768
Iceland,1976,1343,1347,-4,99.7030438
Hungary,1974,125816,126194,-378,99.70046119
Iceland,1981,1656,1661,-5,99.69897652
Australia,1966,103929,104246,-317,99.69591159
Netherlands,1960,87486,87757,-271,99.69119273
Estonia,2009,16099,16149,-50,99.69038331
Finland,2005,47751,47902,-151,99.68477308
Israel,1978,25153,25233,-80,99.68295486
Iceland,1959,1242,1246,-4,99.67897271
Australia,1981,109003,109357,-354,99.67628958
Uruguay,2017,33173,33281,-108,99.67549052
Iceland,2005,1837,1843,-6,99.67444384
Australia,2009,140760,141220,-460,99.6742671
Canada,1956,131961,132395,-434,99.67219306
Venezuela,1981,80346,80611,-265,99.67126075
Belgium,1996,104370,104722,-352,99.66387197
Portugal,1957,101784,102129,-345,99.66219193
Poland,1992,393131,394487,-1356,99.65626244
Iceland,1989,1715,1721,-6,99.65136549
Netherlands,1950,75580,75846,-266,99.64928935
Portugal,1969,101088,101446,-358,99.64710289
Estonia,2015,15243,15297,-54,99.64698961
Canada,1976,167009,167609,-600,99.642024
Russia,1984,1650866,1656817,-5951,99.6408173
Netherlands,1958,84175,84479,-304,99.64014726
Norway,1991,44822,44985,-163,99.637657
Australia,2013,147678,148216,-538,99.63701625
Argentina,2008,299677,300770,-1093,99.63659939
Australia,1965,99715,100081,-366,99.63429622
Romania,1965,163393,163997,-604,99.63170058
Bulgaria,1966,68366,68619,-253,99.63129745
Dominica,1976,535,537,-2,99.62756052
Netherlands,1953,80551,80856,-305,99.62278619
Iceland,1982,1583,1589,-6,99.62240403
Israel,2002,38301,38447,-146,99.62025646
Germany,2014,868356,871668,-3312,99.62003882
South Korea,2014,267692,268729,-1037,99.61410938
Greece,1990,94152,94524,-372,99.60644916
Belgium,1998,104426,104841,-415,99.60416249
France,2015,579891,582205,-2314,99.6025455
Netherlands,1952,75986,76290,-304,99.60152051
Mauritius,2009,8987,9023,-36,99.60101962
Iceland,2011,1988,1996,-8,99.5991984
Israel,1981,25941,26046,-105,99.59686708
Serbia,2013,100300,100707,-407,99.59585729
France,1972,547487,549726,-2239,99.59270618
South Korea,2012,267221,268323,-1102,99.58930095
Estonia,2016,15383,15447,-64,99.58568007
Netherlands,1957,82677,83021,-344,99.585647
Poland,1989,381173,382781,-1608,99.57991645
France,2014,544618,546921,-2303,99.57891542
Netherlands,1961,87923,88297,-374,99.57642955
France,1970,539679,541997,-2318,99.57232236
Russia,1985,1625266,1632281,-7015,99.57023331
Poland,1991,403951,405700,-1749,99.56889327
Denmark,1993,62530,62801,-271,99.56847821
Iceland,1956,1153,1158,-5,99.56822107
South Korea,2011,257396,258515,-1119,99.56714311
Netherlands,1956,84521,84889,-368,99.56649271
Iceland,2014,2048,2057,-9,99.56246962
Iceland,1988,1818,1826,-8,99.5618839
France,2013,556031,558509,-2478,99.5563187
Denmark,2010,54027,54269,-242,99.55407323
Serbia,2009,104000,104470,-470,99.55011008
Denmark,2002,58397,58662,-265,99.54825952
Poland,1990,388440,390221,-1781,99.54359196
Poland,1987,378365,380101,-1736,99.54327929
Iceland,2012,1955,1964,-9,99.54175153
Netherlands,1955,81364,81741,-377,99.53878714
Uruguay,2014,32122,32271,-149,99.53828515
Netherlands,1954,79295,79663,-368,99.53805405
Malta,2010,3010,3024,-14,99.53703704
Russia,1980,1525755,1532910,-7155,99.5332407
Denmark,2004,55637,55898,-261,99.53307811
Iceland,1990,1704,1712,-8,99.53271028
Denmark,1995,62815,63115,-300,99.52467718
Romania,2014,254965,256184,-1219,99.52417013
France,1971,551514,554164,-2650,99.52180221
Belgium,2000,104825,105330,-505,99.52055445
Iceland,1969,1450,1457,-7,99.51956074
Iceland,1972,1447,1454,-7,99.51856946
Iceland,1962,1236,1242,-6,99.51690821
Sweden,1992,94226,94684,-458,99.51628575
Iceland,2004,1824,1833,-9,99.50900164
Iceland,1998,1821,1830,-9,99.50819672
Poland,1986,376316,378182,-1866,99.50658678
Russia,2004,2295402,2306801,-11399,99.50585248
Australia,2006,133739,134405,-666,99.50448272
Guatemala,2015,80876,81279,-403,99.50417697
Canada,2011,242074,243285,-1211,99.50222989
Poland,1985,381458,383376,-1918,99.49970786
Iceland,2008,1987,1997,-10,99.49924887
Greece,1989,92720,93187,-467,99.49885714
Estonia,2011,15204,15282,-78,99.4895956
Luxembourg,1974,4288,4310,-22,99.48955916
Denmark,2012,52011,52278,-267,99.48926891
Iceland,1958,1165,1171,-6,99.48761742
Denmark,2005,54712,54995,-283,99.48540776
Iceland,1957,1157,1163,-6,99.48409286
Denmark,1975,50639,50903,-264,99.48136652
Ireland,1956,33910,34087,-177,99.48074046
Serbia,2011,102935,103473,-538,99.4800576
Belgium,2005,102934,103473,-539,99.47909116
Denmark,1982,55114,55403,-289,99.4783676
Serbia,2012,102400,102937,-537,99.47832169
North Macedonia,2003,18006,18101,-95,99.47516712
Argentina,1989,250815,252148,-1333,99.47134223
Iceland,1996,1879,1889,-10,99.47061938
Romania,1991,251760,253102,-1342,99.46977898
Denmark,2003,57378,57684,-306,99.46952361
Iceland,1953,1118,1124,-6,99.46619217
Poland,1988,370821,372814,-1993,99.46541707
Belgium,1999,104611,105175,-564,99.46375089
Denmark,1992,60546,60873,-327,99.46281603
Romania,2016,258404,259803,-1399,99.46151507
Denmark,1974,51381,51660,-279,99.45993031
Iceland,2010,2019,2030,-11,99.45812808
Denmark,1997,59606,59931,-325,99.4577097
Iceland,1955,1099,1105,-6,99.45701357
Iceland,2003,1826,1836,-10,99.45533769
Denmark,1983,56894,57207,-313,99.45286416
Argentina,1994,253983,255388,-1405,99.44985669
Romania,2012,255539,256956,-1417,99.44854372
Ireland,1953,34591,34784,-193,99.44514719
Canada,1953,127381,128102,-721,99.43716726
Estonia,2014,15470,15558,-88,99.4343746
France,2017,591316,594684,-3368,99.43364879
Poland,1984,364883,366962,-2079,99.43345633
Malta,2005,3130,3148,-18,99.42820839
Ireland,1955,36761,36973,-212,99.42660861
Denmark,1996,60712,61065,-353,99.42192745
Martinique,1970,2538,2553,-15,99.41245593
Denmark,1973,50285,50585,-300,99.40693882
Iceland,1971,1501,1510,-9,99.40397351
Iceland,1960,1167,1174,-7,99.40374787
Canada,1954,124520,125273,-753,99.39891277
Hong Kong,1968,19314,19431,-117,99.39786938
Poland,1981,328923,330953,-2030,99.38661985
France,1961,496896,499963,-3067,99.38655461
Russia,2007,2080445,2093325,-12880,99.38471093
Grenada,2011,803,808,-5,99.38118812
Canada,1955,128154,128954,-800,99.37962374
Armenia,2011,27963,28138,-175,99.37806525
France,1959,505488,508689,-3201,99.37073536
Denmark,2020,54399,54744,-345,99.36979395
Trinidad and Tobago,1991,8192,8244,-52,99.36923823
Poland,1977,312956,314943,-1987,99.36909218
Denmark,2017,52943,53281,-338,99.36562752
Argentina,1968,213313,214677,-1364,99.36462686
Antigua and Barbuda,1964,468,471,-3,99.36305732
Denmark,2016,52490,52830,-340,99.35642627
France,1960,517437,520826,-3389,99.34930284
Denmark,1988,58634,59019,-385,99.3476677
Denmark,1990,60589,60987,-398,99.34740191
Ireland,1952,35105,35336,-231,99.34627575
Russia,2008,2075954,2089676,-13722,99.34334318
Ireland,1951,42382,42663,-281,99.34134965
Denmark,1976,53745,54102,-357,99.3401353
Cuba,1994,78648,79174,-526,99.33564049
Israel,2006,38564,38823,-259,99.33286969
Denmark,1984,56838,57222,-384,99.32892943
Argentina,1983,250844,252539,-1695,99.32881654
Denmark,1991,59318,59719,-401,99.32852191
Denmark,2018,54860,55232,-372,99.3264774
Barbados,1971,2058,2072,-14,99.32432432
Iceland,1999,1901,1914,-13,99.32079415
Cuba,1999,79499,80043,-544,99.3203653
Russia,2006,2166703,2181617,-14914,99.31637863
Malta,1969,3024,3045,-21,99.31034483
Malta,2003,3164,3186,-22,99.30947897
Denmark,1981,56116,56507,-391,99.30805033
Turkey,2016,420124,423054,-2930,99.30741702
France,1950,530294,533995,-3701,99.30692235
Ireland,1954,35535,35784,-249,99.30415828
Singapore,1986,12819,12909,-90,99.30281199
Poland,1983,349388,351851,-2463,99.29998778
Poland,1979,323048,325338,-2290,99.29611665
Hong Kong,1983,26497,26686,-189,99.29176347
Denmark,2007,55281,55677,-396,99.28875478
France,1958,496941,500507,-3566,99.28752245
Russia,2011,1925720,1939563,-13843,99.28628253
Denmark,1978,52586,52965,-379,99.28443312
Serbia,2015,103678,104426,-748,99.28370329
Denmark,2019,53567,53955,-388,99.28088222
Grenada,2018,963,970,-7,99.27835052
Denmark,2006,55218,55621,-403,99.27545352
Denmark,1986,57777,58199,-422,99.27490163
Poland,1971,283702,285800,-2098,99.26592022
Russia,2005,2303935,2321138,-17203,99.25885492
Iceland,2009,2002,2017,-15,99.25632127
Spain,2021,450744,454123,-3379,99.25592846
Belgium,2002,105288,106079,-791,99.25432932
Poland,1972,265250,267245,-1995,99.25349398
Denmark,1979,54369,54779,-410,99.251538
Cuba,1996,79662,80263,-601,99.25121164
France,1957,528229,532248,-4019,99.24490087
Denmark,1985,58078,58521,-443,99.24300678
Luxembourg,1973,4178,4210,-32,99.23990499
Slovenia,1988,19126,19273,-147,99.23727494
Romania,2013,247475,249378,-1903,99.23690141
Chile,1957,91506,92210,-704,99.23652532
South Korea,2013,266257,268315,-2058,99.23299107
Australia,1972,109760,110614,-854,99.22794583
Denmark,1987,57795,58248,-453,99.22229089
Poland,1973,277188,279368,-2180,99.21966725
Hong Kong,1981,24971,25168,-197,99.21726001
Poland,1982,334869,337550,-2681,99.2057473
Malta,2013,3236,3262,-26,99.20294298
Australia,2020,161300,162601,-1301,99.19988192
Bulgaria,1967,74696,75301,-605,99.19655781
Denmark,1989,59070,59550,-480,99.19395466
Denmark,1977,50172,50580,-408,99.19335706
Russia,1981,1524286,1536699,-12413,99.19222958
France,1952,521132,525413,-4281,99.18521239
Poland,1980,350203,353088,-2885,99.18292324
Poland,1975,296896,299343,-2447,99.1825431
Belgium,2001,102992,103841,-849,99.18240387
Russia,2003,2358632,2378150,-19518,99.17927801
Poland,1976,304057,306574,-2517,99.17899104
Slovenia,1991,19324,19485,-161,99.17372338
Kyrgyzstan,2006,38568,38893,-325,99.16437405
Cuba,1990,72144,72753,-609,99.16292112
Denmark,1998,58079,58573,-494,99.15660799
Poland,1974,277085,279456,-2371,99.1515659
Denmark,2009,54531,55001,-470,99.14547008
Belgium,2009,103816,104712,-896,99.14431966
Denmark,2011,52205,52656,-451,99.14349742
Denmark,2013,52182,52633,-451,99.14312314
Malta,2006,3216,3244,-28,99.13686806
Barbados,1970,2064,2082,-18,99.13544669
Slovenia,1989,18669,18832,-163,99.134452
France,1953,553439,558275,-4836,99.13376024
Poland,1978,325104,327954,-2850,99.13097569
France,1955,522708,527292,-4584,99.13065247
Denmark,1999,58722,59237,-515,99.13061094
Poland,1970,266799,269146,-2347,99.12798258
Uruguay,2009,30973,31246,-273,99.12628816
France,1954,515346,519916,-4570,99.12101186
Russia,2009,2010543,2028377,-17834,99.12077489
Saint Vincent and the Grenadines,2003,774,781,-7,99.10371319
Barbados,1969,1987,2005,-18,99.10224439
Luxembourg,1977,4063,4100,-37,99.09756098
Greece,2011,111099,112115,-1016,99.09378763
Denmark,2008,54265,54765,-500,99.08700813
Iceland,1952,1082,1092,-10,99.08424908
Puerto Rico,1962,16575,16729,-154,99.07944288
Ukraine,2019,581114,586531,-5417,99.07643415
France,1956,541891,546968,-5077,99.07179213
Russia,1983,1563995,1578886,-14891,99.05686668
Greece,2010,109084,110125,-1041,99.05471056
Venezuela,1976,76668,77401,-733,99.05298381
Slovenia,1990,18555,18733,-178,99.04980516
Belgium,2007,101384,102358,-974,99.04843784
Saint Lucia,2005,1134,1145,-11,99.03930131
Argentina,1978,233482,235756,-2274,99.03544342
Kyrgyzstan,2014,35551,35898,-347,99.03337233
Luxembourg,1976,4493,4537,-44,99.03019616
South Korea,2017,285534,288350,-2816,99.02340905
Belgium,2003,106209,107257,-1048,99.0229076
Argentina,1981,241904,244293,-2389,99.02207595
Denmark,2015,52224,52741,-517,99.01973796
Belgium,2004,101256,102274,-1018,99.00463461
Russia,2012,1906335,1925504,-19169,99.00446844
South Korea,2016,280827,283680,-2853,98.99428934
South Korea,2015,275895,278713,-2818,98.98892409
Albania,1989,18169,18357,-188,98.97586752
North Macedonia,2002,17960,18146,-186,98.97498071
Russia,2010,2028516,2049572,-21056,98.97266356
Denmark,2014,50993,51527,-534,98.96365013
Belgium,2008,103760,104877,-1117,98.93494284
Belarus,1998,137296,138781,-1485,98.9299688
Hong Kong,1971,20253,20474,-221,98.9205822
Fiji,2009,6404,6474,-70,98.91875193
Trinidad and Tobago,1989,8213,8303,-90,98.91605444
Serbia,2014,101247,102363,-1116,98.90976232
Romania,1990,247086,249826,-2740,98.90323665
Australia,2007,137854,139399,-1545,98.89167067
Uruguay,1978,28033,28350,-317,98.88183422
Grenada,2005,790,799,-9,98.87359199
Iceland,1964,1308,1323,-15,98.86621315
Bulgaria,1969,80183,81103,-920,98.86563999
Israel,1991,31266,31627,-361,98.85857021
Serbia,2021,136622,138202,-1580,98.85674592
Montenegro,2004,5702,5768,-66,98.85575589
Greece,1991,95498,96605,-1107,98.85409658
Kazakhstan,1997,160138,162006,-1868,98.84695629
Serbia,2010,103211,104418,-1207,98.84406903
South Korea,2018,298820,302318,-3498,98.84294022
Guadeloupe,2004,2672,2704,-32,98.81656805
Slovenia,1987,19837,20076,-239,98.80952381
Hong Kong,1956,19286,19519,-233,98.80629131
Malta,2009,3222,3261,-39,98.80404784
Armenia,2009,27560,27895,-335,98.79906793
South Korea,1996,241149,244082,-2933,98.79835465
Estonia,2017,15442,15631,-189,98.79086431
Argentina,2018,336823,340946,-4123,98.79071759
Guyana,2012,5548,5616,-68,98.78917379
Russia,2013,1871809,1894940,-23131,98.77932811
Australia,2012,147098,148916,-1818,98.77917752
Spain,1973,296524,300203,-3679,98.77449592
Malta,1997,2888,2924,-36,98.76880985
Romania,1960,160720,162724,-2004,98.76846685
Luxembourg,1996,3839,3887,-48,98.76511448
Reunion,2010,4236,4289,-53,98.76428072
Greece,2009,108316,109672,-1356,98.76358597
Barbados,1975,2075,2101,-26,98.76249405
Mauritius,2003,8310,8415,-105,98.75222816
Spain,1971,302869,306754,-3885,98.73351285
Georgia,2009,46625,47224,-599,98.73157716
Mauritius,2013,9231,9350,-119,98.72727273
Portugal,1960,95007,96233,-1226,98.72600875
Spain,1974,295275,299112,-3837,98.71720292
Armenia,2006,27202,27556,-354,98.7153433
Turkmenistan,1994,32067,32487,-420,98.70717518
Barbados,2011,2434,2466,-32,98.70235199
Cuba,1992,75457,76454,-997,98.69594789
Puerto Rico,1990,26146,26492,-346,98.69394534
Malta,1995,2708,2744,-36,98.68804665
Malta,1965,3001,3041,-40,98.68464321
Russia,2002,2332272,2363373,-31101,98.68404183
Greece,1993,97419,98721,-1302,98.68113167
Russia,2014,1878039,1903300,-25261,98.67277886
Uruguay,1968,25986,26340,-354,98.65603645
Serbia,2016,100834,102209,-1375,98.65471729
Uruguay,1970,26440,26802,-362,98.64935453
Puerto Rico,1992,27396,27772,-376,98.64611839
Argentina,1980,241125,244455,-3330,98.6377861
Cuba,1985,64430,65321,-891,98.63596699
Israel,1986,29413,29820,-407,98.6351442
Saint Vincent and the Grenadines,2018,928,941,-13,98.61849097
Venezuela,1973,76506,77593,-1087,98.59910043
Bulgaria,1968,72176,73202,-1026,98.59839895
Estonia,2018,15606,15829,-223,98.59119338
Denmark,2001,57632,58461,-829,98.58196062
Serbia,2017,103722,105220,-1498,98.57631629
Spain,1972,280163,284217,-4054,98.57362508
Mauritius,1997,7798,7911,-113,98.57160915
Guyana,2014,5547,5628,-81,98.56076759
Guatemala,2018,83071,84289,-1218,98.55497159
Hong Kong,1955,19069,19349,-280,98.55289679
Mauritius,2014,9438,9577,-139,98.54860604
Greece,1997,99738,101215,-1477,98.54073013
Bulgaria,1970,77095,78240,-1145,98.53655419
Greece,1995,100158,101651,-1493,98.53124908
Oman,2010,7005,7110,-105,98.52320675
France,1973,550333,558625,-8292,98.51564108
Egypt,2016,556148,564595,-8447,98.50388331
Romania,2015,261294,265287,-3993,98.49483767
Portugal,1970,93093,94520,-1427,98.49026661
Trinidad and Tobago,1992,8533,8664,-131,98.48799631
Argentina,1979,234926,238553,-3627,98.47958315
Russia,1997,2015779,2046908,-31129,98.47921841
Saint Vincent and the Grenadines,1996,777,789,-12,98.47908745
French Guiana,2008,774,786,-12,98.47328244
Romania,1978,211846,215143,-3297,98.4675309
Saint Vincent and the Grenadines,2002,765,777,-12,98.45559846
Spain,1951,322329,327386,-5057,98.45534018
Belize,2014,1587,1612,-25,98.44913151
Brazil,2020,1556824,1581430,-24606,98.44406645
Saint Vincent and the Grenadines,1979,693,704,-11,98.4375
Belarus,1999,142025,144288,-2263,98.431609
Fiji,2005,5952,6047,-95,98.42897304
Romania,1969,201225,204463,-3238,98.41633939
Malta,1988,2734,2778,-44,98.41612671
Guadeloupe,2003,2662,2705,-43,98.4103512
Bulgaria,1971,82805,84143,-1338,98.4098499
Mauritius,1993,7275,7393,-118,98.40389558
Russia,2001,2254856,2291683,-36827,98.39301509
Malta,2008,3243,3296,-53,98.39199029
Grenada,2006,792,805,-13,98.38509317
Russia,1998,1988744,2021523,-32779,98.37849977
Colombia,1967,179676,182646,-2970,98.37390362
Mauritius,2020,11060,11243,-183,98.37232056
Saint Vincent and the Grenadines,1987,664,675,-11,98.37037037
Puerto Rico,1997,28963,29443,-480,98.36973135
Belgium,2006,100102,101772,-1670,98.35907715
Spain,1968,277357,281985,-4628,98.35877795
Spain,1970,280170,284846,-4676,98.35841121
Mauritius,2010,8891,9040,-149,98.35176991
Argentina,2000,277148,281810,-4662,98.34569391
Croatia,1988,52686,53583,-897,98.32596159
Armenia,2014,27714,28187,-473,98.32192145
Spain,1953,273571,278249,-4678,98.31877204
Israel,1982,27601,28073,-472,98.31866918
Greece,1992,98231,99922,-1691,98.30767999
Denmark,2000,57044,58026,-982,98.30765519
Spain,1969,297169,302292,-5123,98.30528099
Spain,1954,259874,264397,-4523,98.28931493
Luxembourg,1994,3727,3792,-65,98.28586498
Greece,1996,100740,102507,-1767,98.27621528
Mauritius,2016,9920,10095,-175,98.26646855
Greece,1994,97807,99541,-1734,98.25800424
Greece,2008,107979,109898,-1919,98.25383537
Greece,2005,105091,106968,-1877,98.24526961
Spain,1956,285510,290621,-5111,98.24135214
Malta,1992,2900,2952,-52,98.23848238
Martinique,2002,2649,2697,-48,98.22024472
Puerto Rico,1994,28443,28961,-518,98.21138773
Argentina,2020,376219,383131,-6912,98.19591732
Greece,1998,102668,104555,-1887,98.19520826
Mauritius,2008,8798,8960,-162,98.19196429
Romania,1961,161936,164923,-2987,98.18885177
Romania,1976,204873,208663,-3790,98.18367415
Guatemala,2017,81726,83252,-1526,98.167011
Russia,1982,1504200,1532600,-28400,98.14693984
Hong Kong,1982,25445,25927,-482,98.14093416
Estonia,2019,15186,15474,-288,98.13881349
Colombia,1960,183102,186589,-3487,98.13118673
Reunion,2016,4714,4804,-90,98.1265612
Israel,1987,29244,29803,-559,98.1243499
Greece,1984,88397,90091,-1694,98.11967899
Belarus,1985,105690,107721,-2031,98.11457376
French Guiana,1978,467,476,-9,98.1092437
Egypt,2012,529233,539487,-10254,98.09930545
Spain,1957,289638,295264,-5626,98.09458654
Kuwait,2013,5909,6024,-115,98.09096946
Barbados,2008,2412,2459,-47,98.08865392
Mauritius,1999,7791,7943,-152,98.08636535
Spain,1959,264497,269666,-5169,98.08318438
Cuba,1988,67944,69272,-1328,98.08291951
Guatemala,1969,85174,86840,-1666,98.08152925
Croatia,1992,51800,52816,-1016,98.0763405
Bulgaria,1972,84174,85828,-1654,98.07288997
Spain,1966,269738,275066,-5328,98.06301033
Greece,1999,103304,105345,-2041,98.06255636
Spain,1952,271657,277036,-5379,98.05837508
Spain,1967,274021,279466,-5445,98.05164134
Egypt,2017,547208,558084,-10876,98.05118943
Romania,1984,233699,238360,-4661,98.04455446
Slovenia,1986,19499,19888,-389,98.04404666
Spain,1958,255900,261010,-5110,98.0422206
Puerto Rico,1987,23950,24433,-483,98.02316539
Kazakhstan,1994,160591,163835,-3244,98.01995911
Trinidad and Tobago,1966,7060,7203,-143,98.01471609
Hong Kong,1966,18697,19076,-379,98.01321032
Chile,2006,85639,87375,-1736,98.01316166
Trinidad and Tobago,1987,8054,8218,-164,98.00438063
Armenia,2017,27125,27679,-554,97.9984826
Cuba,2017,106949,109141,-2192,97.99158886
Egypt,2018,560308,571875,-11567,97.97735519
Lithuania,1981,35579,36314,-735,97.97598722
Latvia,1984,33406,34097,-691,97.97342875
Latvia,1980,32100,32764,-664,97.97338542
Croatia,1987,53080,54180,-1100,97.96973053
Greece,2002,103915,106079,-2164,97.96001094
Malta,2011,3267,3336,-69,97.93165468
Latvia,1982,31234,31894,-660,97.93064526
Greece,2007,109895,112227,-2332,97.92206866
Guadeloupe,2015,2906,2968,-62,97.91105121
Armenia,2003,26014,26572,-558,97.90004516
Latvia,1981,32090,32780,-690,97.89505796
Romania,1985,246670,251980,-5310,97.8926899
Ireland,2010,27122,27707,-585,97.8886202
Israel,1976,24012,24530,-518,97.88830004
Puerto Rico,1999,28967,29593,-626,97.88463488
Thailand,1996,342643,350051,-7408,97.88373694
Mexico,1972,476206,486584,-10378,97.86717196
Croatia,1993,50846,51958,-1112,97.85980985
Mauritius,2011,8951,9147,-196,97.85722095
Uruguay,1981,27607,28212,-605,97.85552247
Guatemala,1975,76747,78433,-1686,97.8503946
Saint Lucia,1977,817,835,-18,97.84431138
Luxembourg,1995,3700,3782,-82,97.83183501
Puerto Rico,1966,17506,17894,-388,97.83167542
Spain,1962,271373,277404,-6031,97.82591455
Greece,2000,105170,107513,-2343,97.82072866
Thailand,2006,391126,399859,-8733,97.81598013
Spain,1955,269298,275345,-6047,97.80384608
Russia,1999,2144316,2192510,-48194,97.80188004
Spain,1965,267407,273446,-6039,97.79152008
Latvia,1983,32329,33062,-733,97.78295324
Puerto Rico,1982,21416,21902,-486,97.78102456
Belize,2009,1453,1486,-33,97.77927322
Latvia,1988,32421,33162,-741,97.76551475
Romania,2002,269666,275845,-6179,97.7599739
Romania,2007,251965,257772,-5807,97.74723399
Turkey,2014,383603,392457,-8854,97.74395666
Russia,2000,2225332,2276886,-51554,97.73576718
Belarus,2000,134867,138003,-3136,97.72758563
Spain,1964,267045,273266,-6221,97.72346358
Greece,2003,105529,107990,-2461,97.72108529
Jamaica,1960,14321,14655,-334,97.72091436
Martinique,2001,2701,2764,-63,97.72069465
Cuba,2019,109089,111637,-2548,97.71760259
Greece,2001,102559,104957,-2398,97.71525482
Russia,1996,2082249,2130984,-48735,97.71302835
Lithuania,1982,35040,35868,-828,97.69153563
North Macedonia,2021,28516,29194,-678,97.67760499
Romania,1964,152476,156115,-3639,97.66902604
Latvia,1986,31328,32077,-749,97.66499361
Latvia,1985,34166,34983,-817,97.66457994
North Macedonia,2000,17253,17666,-413,97.66217593
Romania,1962,172429,176586,-4157,97.64590624
Spain,1963,275499,282141,-6642,97.64585792
Puerto Rico,1981,21069,21578,-509,97.64111595
French Guiana,1973,411,421,-10,97.62470309
Romania,1980,231876,237529,-5653,97.62008007
Romania,1989,247306,253365,-6059,97.6085884
Estonia,2021,18375,18826,-451,97.60437693
Puerto Rico,1979,20412,20914,-502,97.59969398
Trinidad and Tobago,1988,8036,8234,-198,97.59533641
Argentina,1984,254452,260774,-6322,97.57567856
Thailand,2016,469085,480792,-11707,97.56505932
Latvia,1989,32584,33401,-817,97.55396545
Spain,1961,256394,262841,-6447,97.54718632
Kuwait,1986,4383,4494,-111,97.53004005
Philippines,2016,582183,597012,-14829,97.51613033
Bulgaria,1974,85239,87412,-2173,97.51407129
Romania,1967,179129,183701,-4572,97.51117305
North Macedonia,1999,16789,17218,-429,97.50842142
Romania,1970,193255,198201,-4946,97.50455346
Puerto Rico,2005,29531,30287,-756,97.50387955
Guatemala,2014,77807,79799,-1992,97.50372812
Serbia,2018,101655,104262,-2607,97.4995684
Greece,2004,104942,107635,-2693,97.49802574
Puerto Rico,2017,30777,31567,-790,97.49738651
Romania,1983,233892,239922,-6030,97.48668317
Kyrgyzstan,2007,38181,39167,-986,97.48257462
Bulgaria,1973,81470,83584,-2114,97.47080781
Latvia,1987,32150,32985,-835,97.46854631
Guyana,2017,5581,5726,-145,97.46769123
Turkey,2015,396971,407307,-10336,97.4623564
North Macedonia,2001,16919,17361,-442,97.45406371
Greece,1980,87282,89568,-2286,97.4477492
Trinidad and Tobago,1973,7517,7714,-197,97.44620171
Slovenia,1985,19854,20379,-525,97.42381864
Mauritius,2012,9103,9344,-241,97.42080479
Chile,2009,91965,94401,-2436,97.41951886
Serbia,2019,101458,104149,-2691,97.41620179
North Macedonia,1998,16870,17318,-448,97.4130962
Armenia,2007,26830,27544,-714,97.40778391
Romania,1963,155767,159934,-4167,97.39455025
Barbados,1978,2050,2105,-55,97.3871734
Argentina,1987,247868,254525,-6657,97.38453983
Puerto Rico,1986,23386,24016,-630,97.37674883
Saint Vincent and the Grenadines,2017,886,910,-24,97.36263736
Kuwait,2015,6481,6657,-176,97.35616644
Armenia,2008,27412,28158,-746,97.35066411
Mauritius,2005,8422,8652,-230,97.34165511
Hong Kong,1957,19357,19886,-529,97.33983707
Cuba,1995,77937,80081,-2144,97.32271076
Cuba,2001,79395,81581,-2186,97.32045452
Puerto Rico,2016,29338,30146,-808,97.31971074
Japan,1951,838998,862235,-23237,97.30502705
French Guiana,2003,721,741,-20,97.30094467
Guadeloupe,2001,2608,2681,-73,97.2771354
Israel,1988,29176,29995,-819,97.26954492
Cuba,2020,112449,115622,-3173,97.25571258
Romania,1987,254286,261470,-7184,97.25245726
Guyana,2010,5433,5587,-154,97.24360122
Costa Rica,1995,14062,14461,-399,97.24085471
Puerto Rico,1976,19893,20458,-565,97.23824421
Romania,1988,253370,260571,-7201,97.23645379
Argentina,1997,270910,278640,-7730,97.22581108
Turkmenistan,1993,31171,32064,-893,97.21494511
Kyrgyzstan,2012,36186,37223,-1037,97.21408806
Colombia,1965,178372,183487,-5115,97.21233657
Jamaica,2012,15624,16075,-451,97.19440124
Greece,1981,86261,88752,-2491,97.19330269
Bulgaria,1975,89974,92583,-2609,97.18198805
Latvia,1995,38931,40064,-1133,97.17202476
Latvia,1996,34320,35322,-1002,97.16324104
Latvia,1998,34200,35199,-999,97.16185119
Japan,1956,724460,745631,-21171,97.1606599
Luxembourg,2021,4217,4341,-124,97.14351532
Japan,1957,752445,774572,-22127,97.1433256
Romania,1972,189793,195391,-5598,97.13497551
Mongolia,2021,19931,20520,-589,97.12962963
Japan,1954,721491,742817,-21326,97.12903717
Mauritius,2000,7806,8037,-231,97.12579321
Japan,1955,693523,714063,-20540,97.12350311
Belarus,1993,128544,132354,-3810,97.12135636
Antigua and Barbuda,1961,503,518,-15,97.1042471
Luxembourg,2011,3722,3833,-111,97.10409601
Latvia,1999,32844,33824,-980,97.10264901
Thailand,2019,494339,509091,-14752,97.10228623
Guatemala,2013,76639,78929,-2290,97.09865829
Puerto Rico,2004,28912,29777,-865,97.09507338
Cuba,2010,91065,93794,-2729,97.09043222
Jamaica,2005,17349,17869,-520,97.08993228
Spain,1960,262260,270174,-7914,97.07077661
Japan,1952,765068,788162,-23094,97.06989172
North Macedonia,1993,15591,16062,-471,97.067613
Romania,1977,208685,214993,-6308,97.06595098
Latvia,2009,29937,30842,-905,97.06568964
Croatia,1986,51740,53306,-1566,97.0622444
Sri Lanka,1982,92244,95036,-2792,97.06216592
Romania,1986,242330,249689,-7359,97.0527336
Montenegro,2001,5431,5596,-165,97.05146533
Latvia,1994,41757,43030,-1273,97.04159888
Maldives,2002,1082,1115,-33,97.04035874
Puerto Rico,1991,26328,27132,-804,97.03670942
Puerto Rico,1977,19895,20503,-608,97.03458031
Saint Kitts and Nevis,1999,425,438,-13,97.03196347
Croatia,1994,49482,50997,-1515,97.02923701
Mongolia,2019,17208,17738,-530,97.01206449
Japan,1959,689932,711205,-21273,97.0088793
Brazil,2019,1349801,1391436,-41635,97.00776751
Japan,1953,772547,796456,-23909,96.99807648
Bahamas,1998,1776,1831,-55,96.99617695
North Macedonia,1992,16022,16519,-497,96.9913433
Cuba,1998,77565,79989,-2424,96.96958332
Brazil,2017,1312664,1353694,-41030,96.96903436
Luxembourg,2003,3930,4053,-123,96.96521095
Romania,1973,203559,209965,-6406,96.94901531
Latvia,1997,33533,34589,-1056,96.94700627
Estonia,2020,15686,16180,-494,96.94684796
Latvia,2007,33056,34098,-1042,96.94410229
Mauritius,2002,8081,8336,-255,96.94097889
Cuba,2015,99691,102842,-3151,96.9360767
Latvia,2000,32205,33223,-1018,96.93585769
Mongolia,2018,17330,17878,-548,96.93478018
Lithuania,1985,39169,40411,-1242,96.9265794
Belarus,2001,140299,144755,-4456,96.92169528
Israel,1990,28734,29648,-914,96.91716136
Saint Kitts and Nevis,1977,502,518,-16,96.91119691
Greece,1982,86345,89098,-2753,96.91014389
Romania,1982,224120,231277,-7157,96.90544239
Japan,1950,904876,933809,-28933,96.90161478
Bulgaria,1976,88348,91182,-2834,96.89193042
Hong Kong,1975,21191,21871,-680,96.89086004
Latvia,1991,34778,35896,-1118,96.88544685
Reunion,2006,4322,4461,-139,96.8841067
Brazil,2016,1309774,1351923,-42149,96.88229285
Mauritius,2015,9496,9803,-307,96.86830562
Luxembourg,2001,3587,3703,-116,96.86740481
Seychelles,2021,925,955,-30,96.85863874
Latvia,1992,35430,36584,-1154,96.84561557
Barbados,2007,2362,2439,-77,96.84296843
Luxembourg,2002,3603,3721,-118,96.82880946
Croatia,1989,52569,54296,-1727,96.81928687
Latvia,2008,31031,32053,-1022,96.8115309
Barbados,2000,2429,2509,-80,96.81147868
Japan,1958,684189,706738,-22549,96.80942584
Dominica,2018,576,595,-19,96.80672269
Belarus,2002,146658,151510,-4852,96.79757112
Russia,1995,2203811,2276818,-73007,96.79346351
Latvia,1993,39229,40529,-1300,96.79242024
Mauritius,2004,8259,8533,-274,96.78893707
Egypt,2019,570580,589548,-18968,96.78261991
Latvia,2006,33115,34218,-1103,96.77655035
Greece,2006,104968,108465,-3497,96.7759185
Saint Kitts and Nevis,1987,479,495,-16,96.76767677
Malta,2007,3111,3215,-104,96.7651633
Uruguay,1975,27436,28354,-918,96.76236157
Lithuania,2008,43832,45301,-1469,96.75724598
Latvia,1990,34812,35984,-1172,96.74299689
Japan,1960,706599,730473,-23874,96.73170672
Barbados,1980,2012,2080,-68,96.73076923
Lithuania,2009,42032,43454,-1422,96.72757399
Croatia,2008,52151,53919,-1768,96.72100744
Latvia,2001,32991,34111,-1120,96.71660168
Turkmenistan,1996,32266,33362,-1096,96.71482525
Luxembourg,1992,3880,4012,-132,96.70987039
Trinidad and Tobago,1960,6608,6833,-225,96.70715645
Hong Kong,2015,46757,48357,-1600,96.69127531
Latvia,2010,30079,31115,-1036,96.6704162
Chile,2010,97930,101306,-3376,96.66752216
Venezuela,1975,74574,77148,-2574,96.66355576
Cuba,1977,55957,57889,-1932,96.66257838
Barbados,2009,2363,2445,-82,96.64621677
Croatia,2010,52096,53905,-1809,96.64409609
Bulgaria,1977,94362,97646,-3284,96.636831
Japan,1961,695644,719858,-24214,96.63628104
Lithuania,2010,42120,43587,-1467,96.63431757
Serbia,2020,116850,120926,-4076,96.62934357
Cuba,2005,84824,87791,-2967,96.6203825
Luxembourg,2016,3858,3993,-135,96.6190834
Thailand,2002,380364,393681,-13317,96.61731199
Philippines,2018,590709,611429,-20720,96.61121733
Romania,1975,197538,204478,-6940,96.60599184
Lithuania,2007,45624,47227,-1603,96.60575518
Lithuania,1986,35788,37046,-1258,96.60422178
Kuwait,1994,3464,3586,-122,96.59788065
Chile,1955,87843,90942,-3099,96.59233358
Croatia,2009,52414,54280,-1866,96.56226971
Costa Rica,1994,13314,13788,-474,96.56222802
Belize,1997,1175,1217,-42,96.54889071
Grenada,1991,699,724,-25,96.54696133
Croatia,2007,52367,54240,-1873,96.54682891
Antigua and Barbuda,2006,474,491,-17,96.53767821
Reunion,2003,4041,4186,-145,96.53607262
Romania,1974,191286,198154,-6868,96.5340089
Japan,1962,710265,735811,-25546,96.52818455
Hong Kong,2014,45710,47357,-1647,96.52216145
Jamaica,2013,15886,16460,-574,96.5127582
Armenia,2012,27600,28598,-998,96.51024547
Belarus,2003,143203,148407,-5204,96.49342686
Japan,1966,670342,694705,-24363,96.49304381
Barbados,1995,2500,2591,-91,96.48784253
Kazakhstan,1993,156317,162029,-5712,96.47470515
Japan,1963,670770,695302,-24532,96.47174897
Croatia,2005,51790,53686,-1896,96.46835302
Saint Lucia,2014,1302,1350,-48,96.44444444
Kyrgyzstan,2008,37711,39106,-1395,96.43277246
Saint Vincent and the Grenadines,2001,755,783,-28,96.42401022
Croatia,2006,50378,52250,-1872,96.41722488
Trinidad and Tobago,1990,8196,8501,-305,96.4121868
Puerto Rico,2000,28365,29425,-1060,96.39762107
Cuba,1997,77316,80209,-2893,96.39317284
Croatia,2011,51019,52934,-1915,96.38228738
Romania,1971,194306,201621,-7315,96.3719057
Croatia,1997,51964,53925,-1961,96.36346778
Dominica,1971,662,687,-25,96.36098981
Luxembourg,2014,3705,3845,-140,96.35890767
Kuwait,1987,4287,4449,-162,96.3587323
Croatia,1990,52192,54170,-1978,96.3485324
Luxembourg,1998,3743,3885,-142,96.34491634
Grenada,2015,869,902,-33,96.34146341
Mauritius,1991,6815,7074,-259,96.33870512
Reunion,2012,4180,4339,-159,96.33556119
Luxembourg,1997,3766,3910,-144,96.31713555
Latvia,2004,32041,33267,-1226,96.31466619
Lithuania,2006,44813,46529,-1716,96.31197748
Panama,2014,18171,18867,-696,96.31101924
Latvia,2002,32498,33744,-1246,96.3074917
Luxembourg,2000,3623,3762,-139,96.30515683
South Korea,1994,230677,239551,-8874,96.29556963
Japan,1964,673067,698965,-25898,96.29480732
Latvia,2003,32437,33686,-1249,96.29222823
Kuwait,1984,4544,4719,-175,96.2915872
Panama,2017,19482,20234,-752,96.28348325
Lithuania,1996,42896,44556,-1660,96.27435138
Hong Kong,1960,19145,19887,-742,96.26891939
Japan,1973,709416,736935,-27519,96.26574935
Uruguay,1959,23517,24431,-914,96.25885146
Trinidad and Tobago,1980,7506,7798,-292,96.25545012
Latvia,2011,28550,29661,-1111,96.25434072
Latvia,2005,32777,34053,-1276,96.25289989
Lithuania,2005,43799,45505,-1706,96.25096143
Antigua and Barbuda,2001,462,480,-18,96.25
Japan,1974,710510,738200,-27690,96.24898402
Panama,2013,17767,18462,-695,96.23551078
Guyana,2011,5391,5602,-211,96.23348804
Lithuania,1994,46486,48307,-1821,96.23035999
Luxembourg,2015,3839,3990,-151,96.21553885
Lithuania,1995,45306,47090,-1784,96.21150987
Bulgaria,1978,92445,96092,-3647,96.20467885
Thailand,2007,393254,408809,-15555,96.19504463
Latvia,2012,29054,30206,-1152,96.18618817
Cuba,2014,96330,100151,-3821,96.18476101
Lithuania,1987,36917,38382,-1465,96.18310666
Israel,1989,28580,29718,-1138,96.17067097
Puerto Rico,1980,20412,21226,-814,96.16508056
Uruguay,1965,24771,25759,-988,96.16444738
Brazil,2018,1316719,1369336,-52617,96.15748071
Jamaica,1961,14193,14761,-568,96.15202222
Barbados,1993,2421,2518,-97,96.1477363
Brazil,2014,1227039,1276208,-49169,96.14725813
Uruguay,1982,27172,28261,-1089,96.14663317
Puerto Rico,1973,19257,20029,-772,96.1455889
Japan,1975,702275,730464,-28189,96.14094603
Mauritius,1995,7298,7591,-293,96.14016599
Luxembourg,2005,3481,3621,-140,96.13366473
Hong Kong,2010,42699,44420,-1721,96.12561909
Croatia,1985,52067,54167,-2100,96.12310078
Luxembourg,2009,3530,3673,-143,96.10672475
Lithuania,2004,41340,43016,-1676,96.10377534
Cuba,1991,71709,74625,-2916,96.09246231
Croatia,1999,51953,54067,-2114,96.09003644
Lithuania,2003,40990,42662,-1672,96.08082134
Croatia,1998,52311,54445,-2134,96.08044816
Panama,2010,16542,17219,-677,96.06829665
Montenegro,2003,5704,5938,-234,96.05927922
Mauritius,1994,7234,7531,-297,96.05630062
Luxembourg,2006,3623,3772,-149,96.04984093
Japan,1976,703270,732200,-28930,96.04889374
Croatia,2012,51710,53843,-2133,96.03848225
Puerto Rico,1985,23192,24149,-957,96.03710299
Japan,1965,700438,729342,-28904,96.03697579
North Macedonia,1997,16596,17281,-685,96.03610902
Thailand,2000,365583,380684,-15101,96.03319288
Colombia,1974,163096,169838,-6742,96.03033479
Georgia,2019,46659,48588,-1929,96.02988392
Bahrain,1988,1523,1586,-63,96.02774275
North Macedonia,1991,14789,15401,-612,96.02623206
Lithuania,2011,41037,42738,-1701,96.01993542
Reunion,2015,4531,4719,-188,96.01610511
Cuba,1987,65079,67782,-2703,96.01221563
Peru,2020,233997,243717,-9720,96.01176775
Georgia,2020,50537,52643,-2106,95.99946812
North Macedonia,1995,16338,17020,-682,95.99294947
Japan,1977,690074,718893,-28819,95.99119758
Lithuania,1997,41143,42863,-1720,95.98721508
Panama,2012,17350,18078,-728,95.97300586
Venezuela,1990,90072,93872,-3800,95.95193455
Croatia,2004,49756,51858,-2102,95.94662347
Lithuania,1992,41455,43207,-1752,95.94510149
Venezuela,1982,78329,81640,-3311,95.94439
Costa Rica,1997,14260,14864,-604,95.93649085
Kazakhstan,1998,154314,160879,-6565,95.91929338
Japan,1978,695821,725432,-29611,95.91815635
Japan,1979,689664,719085,-29421,95.90855045
Lithuania,1993,46107,48075,-1968,95.90639626
Japan,1968,686555,715869,-29314,95.90511672
Romania,1981,224635,234254,-9619,95.89377343
Kyrgyzstan,2015,34809,36301,-1492,95.88992039
Croatia,2013,50386,52547,-2161,95.8874912
Maldives,2007,1119,1167,-48,95.88688946
Colombia,1963,176898,184487,-7589,95.88643102
Japan,1969,693787,723559,-29772,95.885339
Costa Rica,1990,11366,11854,-488,95.88324616
Malta,1994,2698,2814,-116,95.87775409
Lithuania,2013,41511,43297,-1786,95.87500289
Lithuania,1991,41013,42783,-1770,95.86284272
Croatia,2014,50839,53039,-2200,95.85210883
Hong Kong,2005,38683,40358,-1675,95.84964567
Luxembourg,2010,3621,3778,-157,95.8443621
Bulgaria,1979,94403,98498,-4095,95.84255518
Lithuania,1988,37649,39285,-1636,95.83556065
Latvia,2013,28687,29934,-1247,95.8341685
Montenegro,2007,5979,6239,-260,95.83266549
Montenegro,2008,5708,5957,-249,95.82004365
Trinidad and Tobago,1968,7116,7427,-311,95.81257574
Costa Rica,2004,16475,17196,-721,95.80716446
Japan,1967,675006,704553,-29547,95.80627717
Uruguay,1966,24862,25951,-1089,95.80362992
Philippines,2017,579237,604642,-25405,95.79834017
Grenada,2007,751,784,-33,95.79081633
Trinidad and Tobago,1961,6750,7047,-297,95.78544061
Costa Rica,1989,11273,11770,-497,95.77740017
Brazil,2015,1264175,1319930,-55755,95.77591236
Hong Kong,2008,41530,43362,-1832,95.77510262
Lithuania,2012,40938,42745,-1807,95.77260498
Panama,2016,18882,19720,-838,95.7505071
Reunion,2008,4118,4301,-183,95.74517554
Grenada,2016,899,939,-40,95.74014909
Armenia,1996,24935,26046,-1111,95.73446978
Antigua and Barbuda,2013,471,492,-21,95.73170732
Barbados,1960,2127,2222,-95,95.72457246
Lithuania,2002,41072,42907,-1835,95.72330855
Lithuania,1998,40757,42578,-1821,95.72314341
Lithuania,1990,39760,41537,-1777,95.72188651
Lithuania,1999,40003,41806,-1803,95.68722193
Japan,1980,722801,755442,-32641,95.67921826
Luxembourg,2013,3671,3837,-166,95.67370341
Armenia,2019,26185,27370,-1185,95.67044209
Puerto Rico,1974,19490,20375,-885,95.65644172
South Korea,2019,295110,308519,-13409,95.65375228
Costa Rica,1992,12255,12812,-557,95.65251327
Lithuania,1989,38150,39890,-1740,95.63800451
Mauritius,1996,7508,7851,-343,95.63112979
Croatia,2015,54205,56685,-2480,95.62494487
Kuwait,1983,4655,4868,-213,95.62448644
Japan,1970,712962,745670,-32708,95.61360924
Belarus,1991,114650,119911,-5261,95.61257933
French Guiana,2005,740,774,-34,95.60723514
Japan,1981,720262,753363,-33101,95.60623498
Croatia,1996,50636,52964,-2328,95.60456159
Luxembourg,1999,3612,3779,-167,95.58084149
Croatia,2000,50246,52570,-2324,95.5792277
Thailand,2010,411331,430364,-19033,95.57746466
Japan,1982,711883,744881,-32998,95.57003065
Croatia,2003,52575,55017,-2442,95.56137194
Jamaica,1965,14311,14976,-665,95.55956197
Belarus,2007,132993,139199,-6206,95.54163464
Maldives,2017,1241,1299,-58,95.53502694
Egypt,2014,531864,556743,-24879,95.53133133
Croatia,2016,51542,53955,-2413,95.52775461
Venezuela,1974,73801,77257,-3456,95.52661895
Greece,1979,82338,86197,-3859,95.52304605
Japan,1971,684521,716624,-32103,95.52024493
Colombia,1962,177208,185533,-8325,95.51292762
French Guiana,1975,404,423,-19,95.50827423
Luxembourg,2012,3721,3896,-175,95.50821355
Croatia,2020,57023,59705,-2682,95.50791391
Mauritius,1992,6866,7189,-323,95.50702462
Japan,1972,683751,715921,-32170,95.50648745
Lithuania,2014,40252,42147,-1895,95.50383183
Colombia,1966,174712,182973,-8261,95.48512622
Greece,1978,81615,85479,-3864,95.47959148
Japan,1983,740038,775088,-35050,95.47793283
Puerto Rico,2002,27924,29249,-1325,95.4699306
Grenada,2013,820,859,-39,95.45983702
Costa Rica,1996,13993,14659,-666,95.45671601
Lithuania,2015,41776,43765,-1989,95.45527248
Cuba,2018,106196,111265,-5069,95.44420977
Trinidad and Tobago,1956,7136,7477,-341,95.43934733
Qatar,2013,2133,2235,-102,95.43624161
Bulgaria,1980,97950,102637,-4687,95.4334207
Sri Lanka,1968,94903,99455,-4552,95.42305565
Turkmenistan,1995,31404,32913,-1509,95.41518549
Thailand,2008,397327,416439,-19112,95.41061236
Malta,2002,3031,3177,-146,95.40446963
Luxembourg,2004,3424,3589,-165,95.40261911
Costa Rica,1991,11795,12364,-569,95.39792947
Lithuania,2000,38919,40797,-1878,95.39672035
Venezuela,1977,74343,77945,-3602,95.37879274
Japan,1984,740247,776302,-36055,95.35554462
Chile,2011,94985,99613,-4628,95.35402006
Croatia,2017,53477,56089,-2612,95.34311541
Trinidad and Tobago,1976,7388,7750,-362,95.32903226
Japan,1985,752283,789154,-36871,95.3277814
Luxembourg,2007,3691,3872,-181,95.32541322
Singapore,1990,13889,14572,-683,95.3129289
Lithuania,2001,40399,42387,-1988,95.30988275
Qatar,2008,1948,2044,-96,95.30332681
Mauritius,2001,7761,8144,-383,95.29715128
Hong Kong,2012,43672,45832,-2160,95.28713563
Thailand,2003,384131,403132,-19001,95.28665549
Trinidad and Tobago,1963,6668,6998,-330,95.28436696
Colombia,1964,175346,184027,-8681,95.28275742
Costa Rica,1988,10944,11490,-546,95.24804178
Belarus,2008,133879,140568,-6689,95.24144898
Montenegro,2005,5839,6131,-292,95.23731855
Armenia,2002,25554,26832,-1278,95.23703041
Belarus,1982,93840,98543,-4703,95.22746415
Hong Kong,1977,23459,24640,-1181,95.20698052
Belarus,2009,135097,141899,-6802,95.20644966
Luxembourg,2008,3434,3607,-173,95.20377045
Montenegro,2009,5866,6162,-296,95.19636482
Mauritius,1998,7651,8038,-387,95.18536949
Trinidad and Tobago,1985,8026,8432,-406,95.18500949
Guatemala,2005,70950,74541,-3591,95.182517
Kyrgyzstan,2011,35941,37763,-1822,95.17517146
Barbados,1985,2226,2339,-113,95.16887559
Mauritius,1980,6685,7025,-340,95.16014235
Kyrgyzstan,2010,36174,38015,-1841,95.1571748
Croatia,2002,50569,53158,-2589,95.1296136
Croatia,2019,51794,54451,-2657,95.12038346
Japan,1986,750620,789201,-38581,95.11138481
Brazil,2013,1210474,1272713,-62239,95.10973802
French Guiana,2001,660,694,-34,95.10086455
Belarus,2011,135090,142061,-6971,95.09295303
Puerto Rico,2003,28202,29658,-1456,95.09070065
Georgia,2018,46524,48926,-2402,95.0905449
Kuwait,1980,4932,5187,-255,95.0838635
Puerto Rico,1983,21400,22507,-1107,95.08153019
Armenia,2013,27196,28608,-1412,95.06431767
Cuba,1986,63145,66428,-3283,95.05780695
Mexico,1969,458886,482780,-23894,95.05074775
Thailand,2005,395374,415962,-20588,95.05050942
Mauritius,1989,6946,7308,-362,95.04652436
Albania,2003,17965,18903,-938,95.03782468
Kuwait,1979,5028,5291,-263,95.02929503
Saint Lucia,1973,840,884,-44,95.02262443
Hong Kong,2007,39963,42057,-2094,95.02104287
Reunion,2013,4253,4476,-223,95.0178731
Guyana,2013,5378,5660,-282,95.01766784
Belarus,2010,137132,144325,-7193,95.01610948
Saint Lucia,1997,972,1023,-51,95.01466276
North Macedonia,1996,16062,16905,-843,95.01330967
Kazakhstan,2006,157210,165485,-8275,94.99954679
Hong Kong,2016,46662,49121,-2459,94.99399442
Japan,1987,751172,790769,-39597,94.99259581
Belarus,1981,93136,98058,-4922,94.98052173
French Guiana,1972,397,418,-21,94.97607656
Cuba,1989,67356,70922,-3566,94.97194101
South Korea,2020,304948,321110,-16162,94.9668338
Maldives,2018,1301,1370,-69,94.96350365
Cuba,2000,76463,80523,-4060,94.95796232
Guatemala,2006,69756,73464,-3708,94.95262986
Chile,1956,84199,88694,-4495,94.93201344
Bulgaria,2013,104345,109918,-5573,94.9298568
Chile,2017,106388,112090,-5702,94.91301633
Venezuela,1994,98991,104309,-5318,94.90168634
Saint Vincent and the Grenadines,1985,651,686,-35,94.89795918
Japan,1989,788594,831028,-42434,94.89379419
Bulgaria,1981,95441,100577,-5136,94.89346471
Japan,1988,793014,835803,-42789,94.88049217
Trinidad and Tobago,1982,7641,8054,-413,94.87211324
Antigua and Barbuda,2002,444,468,-24,94.87179487
Barbados,2012,2326,2452,-126,94.86133768
Bulgaria,2016,107580,113430,-5850,94.84263422
Latvia,2021,34231,36094,-1863,94.83847731
Panama,2005,14183,14955,-772,94.83784687
Martinique,1974,2296,2421,-125,94.83684428
Puerto Rico,1972,19010,20045,-1035,94.83661761
Puerto Rico,2007,29169,30762,-1593,94.82153306
Bulgaria,2012,109281,115250,-5969,94.8208243
Bulgaria,2014,108952,114907,-5955,94.8175481
Malta,2004,2999,3163,-164,94.815049
Costa Rica,1993,12544,13230,-686,94.81481481
Latvia,2014,28201,29746,-1545,94.80602434
Lithuania,2016,41106,43359,-2253,94.80384695
Bulgaria,2011,108258,114213,-5955,94.78605763
Latvia,2015,28185,29737,-1552,94.78091267
Greece,1976,81818,86329,-4511,94.7746412
Mexico,1971,458323,483615,-25292,94.77022011
Trinidad and Tobago,1986,7699,8125,-426,94.75692308
Kyrgyzstan,2003,35945,37935,-1990,94.75418479
Bulgaria,2010,110165,116301,-6136,94.72403505
Saint Lucia,1996,933,985,-52,94.72081218
Belarus,2013,125326,132318,-6992,94.71576052
Brunei,1996,1002,1058,-56,94.70699433
Bulgaria,2015,110117,116272,-6155,94.70637815
Japan,1990,820305,866210,-45905,94.70047679
Japan,1991,829797,876244,-46447,94.6993075
Martinique,1985,2140,2260,-120,94.69026549
Bulgaria,2017,109791,115964,-6173,94.67679625
Barbados,2006,2326,2457,-131,94.66829467
Trinidad and Tobago,1977,7311,7723,-412,94.66528551
Bahamas,2002,1827,1930,-103,94.66321244
Venezuela,1972,73548,77695,-4147,94.66246219
Mauritius,1990,6854,7241,-387,94.65543433
Albania,1992,17238,18215,-977,94.63628877
Belarus,2014,121542,128437,-6895,94.63160927
Greece,1977,83750,88503,-4753,94.62956058
Croatia,2001,49552,52368,-2816,94.62267033
Chile,2015,103327,109199,-5872,94.62266138
Bosnia and Herzegovina,2020,44427,46952,-2525,94.62216732
Japan,1992,856643,905681,-49038,94.58551079
Panama,2018,19720,20849,-1129,94.58487218
Saint Kitts and Nevis,1972,541,572,-31,94.58041958
Albania,1987,17326,18319,-993,94.57939844
Costa Rica,1999,15052,15917,-865,94.56555884
Guadeloupe,1974,2401,2539,-138,94.56478929
Cuba,2008,86423,91396,-4973,94.55884284
Kazakhstan,2011,144197,152509,-8312,94.54982985
Chile,2016,104026,110030,-6004,94.54330637
Montenegro,2000,5412,5725,-313,94.53275109
Armenia,2021,34388,36379,-1991,94.52706232
Montenegro,2002,5513,5833,-320,94.51397223
Bulgaria,2020,124735,131998,-7263,94.4976439
Japan,1993,878532,929713,-51181,94.4949678
Kazakhstan,2007,158294,167518,-9224,94.49372605
Fiji,2002,5642,5971,-329,94.49003517
Chile,2013,99769,105599,-5830,94.47911439
Bulgaria,2009,108068,114399,-6331,94.46586072
Trinidad and Tobago,1967,6775,7172,-397,94.4645845
Montenegro,2006,5968,6319,-351,94.44532363
Saint Lucia,2004,1070,1133,-63,94.43954104
Thailand,2011,414670,439101,-24431,94.43613201
Kyrgyzstan,2019,33295,35261,-1966,94.42443493
Bulgaria,1982,100293,106217,-5924,94.42273836
Chile,2007,89558,94861,-5303,94.40971527
Lithuania,2020,43547,46127,-2580,94.40674659
Colombia,1961,175612,186049,-10437,94.39018753
Barbados,1994,2406,2549,-143,94.38995685
Puerto Rico,1984,21732,23025,-1293,94.38436482
Japan,1994,875933,928086,-52153,94.38058542
Thailand,2015,445964,472520,-26556,94.37992043
Uruguay,1964,24115,25552,-1437,94.37617408
Bulgaria,2008,110523,117122,-6599,94.36570414
Iceland,2019,2277,2413,-136,94.36386241
Panama,2015,18182,19268,-1086,94.36371185
Costa Rica,1985,10493,11121,-628,94.35302581
Hong Kong,1961,18737,19859,-1122,94.35016869
Japan,1996,896211,949894,-53683,94.34852731
Kyrgyzstan,2005,36992,39209,-2217,94.34568594
Guatemala,2010,72748,77115,-4367,94.33702911
Qatar,2007,1781,1888,-107,94.33262712
Chile,2014,101960,108090,-6130,94.32880007
Reunion,2014,4349,4611,-262,94.31793537
Trinidad and Tobago,1957,7283,7722,-439,94.31494431
Japan,1995,922139,977753,-55614,94.31206041
Albania,1988,17273,18315,-1042,94.31067431
Costa Rica,2001,15609,16551,-942,94.308501
Lithuania,2017,40142,42582,-2440,94.26987929
Mexico,1968,452910,480514,-27604,94.25531826
Qatar,2012,2031,2155,-124,94.24593968
French Guiana,2004,719,763,-44,94.23328965
Fiji,2004,5628,5973,-345,94.22400804
Guatemala,2009,71707,76104,-4397,94.2223799
Trinidad and Tobago,1984,7819,8299,-480,94.21617062
Mauritius,2017,9914,10524,-610,94.20372482
Bosnia and Herzegovina,2011,35028,37184,-2156,94.20180723
Japan,1997,913402,969625,-56223,94.20157277
Colombia,1959,176834,187724,-10890,94.19893034
Venezuela,1980,76834,81573,-4739,94.19047969
Trinidad and Tobago,1952,7999,8493,-494,94.18344519
Japan,1998,936484,994334,-57850,94.18203541
Costa Rica,2000,14944,15868,-924,94.17695992
Trinidad and Tobago,1983,7546,8013,-467,94.17197055
Maldives,2008,1066,1132,-66,94.16961131
Antigua and Barbuda,2003,451,479,-28,94.15448852
Bulgaria,2019,108083,114802,-6719,94.14731451
French Guiana,2010,771,819,-48,94.13919414
Hong Kong,1987,26959,28642,-1683,94.12401369
Trinidad and Tobago,1955,7462,7929,-467,94.11022828
Reunion,2009,4104,4362,-258,94.08528198
Bulgaria,2007,113004,120112,-7108,94.08218996
Kazakhstan,2005,157119,167065,-9946,94.04662856
Latvia,2018,28530,30338,-1808,94.04047729
Bulgaria,1983,102182,108661,-6479,94.03741913
Reunion,2011,4034,4290,-256,94.03263403
Sri Lanka,1966,94419,100429,-6010,94.01567276
Thailand,2014,435624,463360,-27736,94.01415746
Latvia,2016,28215,30012,-1797,94.01239504
Reunion,2002,4001,4256,-255,94.00845865
Kazakhstan,2010,145873,155171,-9298,94.00790096
Brazil,2011,1170498,1245125,-74627,94.00646521
Japan,1999,982031,1044710,-62679,94.00034459
Bulgaria,2006,113438,120687,-7249,93.99355357
Thailand,2004,393592,418808,-25216,93.9791026
Bulgaria,1984,101419,107927,-6508,93.96999824
Sri Lanka,1980,91020,96865,-5845,93.96582873
Panama,2007,14777,15729,-952,93.94748554
Trinidad and Tobago,1979,7060,7515,-455,93.94544245
Saint Kitts and Nevis,1988,465,495,-30,93.93939394
Cuba,2009,86940,92560,-5620,93.92826275
Cuba,2013,92273,98243,-5970,93.92323117
Trinidad and Tobago,1975,6899,7346,-447,93.91505581
Venezuela,1983,76725,81702,-4977,93.90834986
Hong Kong,1964,18110,19285,-1175,93.90718175
Japan,2000,961653,1024232,-62579,93.89015379
Kazakhstan,2008,152706,162649,-9943,93.88683607
Latvia,2017,28459,30315,-1856,93.87761834
Cuba,2004,81110,86402,-5292,93.87514178
Puerto Rico,2011,29758,31700,-1942,93.87381703
French Guiana,1968,383,408,-25,93.87254902
Qatar,2005,1547,1648,-101,93.87135922
Belarus,1992,116674,124296,-7622,93.86786381
Mexico,1973,458915,488957,-30042,93.85590144
Guatemala,2001,67947,72397,-4450,93.85333646
Iceland,2020,2305,2456,-151,93.85179153
Romania,2006,258094,275010,-16916,93.84895095
Hong Kong,2003,36423,38815,-2392,93.83743398
Bosnia and Herzegovina,2019,38829,41386,-2557,93.82158218
Puerto Rico,2014,30152,32139,-1987,93.81748032
Hong Kong,1984,25580,27266,-1686,93.81647473
Venezuela,2016,190474,203029,-12555,93.81615434
Japan,2001,970331,1034354,-64023,93.81033959
French Guiana,2012,788,840,-52,93.80952381
Chile,2012,98711,105229,-6518,93.80589001
Panama,2006,14358,15307,-949,93.80022212
Croatia,1995,50536,53878,-3342,93.79709715
Mauritius,2007,8323,8875,-552,93.78028169
Chile,2008,86783,92540,-5757,93.77890642
Costa Rica,1998,14708,15684,-976,93.77709768
Kyrgyzstan,1994,37109,39573,-2464,93.77353246
Bulgaria,1986,104039,110958,-6919,93.76430722
Guatemala,1990,73344,78226,-4882,93.75910822
Kazakhstan,2012,142880,152408,-9528,93.74835967
Hong Kong,1986,26030,27766,-1736,93.74774905
Bulgaria,1985,107485,114658,-7173,93.74400391
South Africa,2009,572673,610904,-38231,93.74189725
Cuba,1978,54949,58631,-3682,93.72004571
Luxembourg,2017,4012,4281,-269,93.7164214
Qatar,2009,2010,2145,-135,93.70629371
Kyrgyzstan,2013,34880,37224,-2344,93.70298732
Cuba,2016,99388,106068,-6680,93.70215334
Thailand,2017,458010,488817,-30807,93.69764145
Costa Rica,1987,10687,11406,-719,93.69630019
Barbados,1989,2303,2458,-155,93.69406021
Japan,2002,982379,1048503,-66124,93.6934849
North Macedonia,1994,15771,16837,-1066,93.66870583
Lithuania,2021,47746,50975,-3229,93.66552231
Bulgaria,2018,108526,115908,-7382,93.63115574
France,1951,530294,566424,-36130,93.6213861
Latvia,2020,28589,30538,-1949,93.61778767
Kyrgyzstan,1995,36916,39435,-2519,93.61227336
Jamaica,2010,15440,16494,-1054,93.6097975
Malta,2000,2973,3176,-203,93.60831234
Bulgaria,2005,113374,121129,-7755,93.59773465
Belarus,1988,102671,109697,-7026,93.59508464
Kazakhstan,2003,155302,165942,-10640,93.58812115
Mauritius,1979,6625,7079,-454,93.58666478
Thailand,2013,426065,455271,-29206,93.58491975
Saint Kitts and Nevis,1974,510,545,-35,93.57798165
Egypt,1987,466161,498249,-32088,93.55984658
Egypt,2010,491609,525460,-33851,93.55783504
Belarus,1990,109582,117128,-7546,93.55747558
Lithuania,2018,39574,42305,-2731,93.54449829
Puerto Rico,1969,17658,18877,-1219,93.5424061
Puerto Rico,1975,19073,20390,-1317,93.54095145
Romania,1959,186767,199692,-12925,93.5275324
Kuwait,2014,6031,6449,-418,93.51837494
Dominica,1974,503,538,-35,93.49442379
Hong Kong,2017,45883,49078,-3195,93.48995477
Argentina,1986,239599,256323,-16724,93.47541969
Latvia,2019,27492,29413,-1921,93.46887431
Venezuela,1985,79356,84914,-5558,93.45455402
Japan,2003,1014951,1086210,-71259,93.43966636
Hong Kong,1985,25359,27140,-1781,93.43773029
French Guiana,2002,669,716,-47,93.43575419
Kazakhstan,2000,148855,159320,-10465,93.4314587
Brazil,2010,1136946,1217149,-80203,93.4105849
Puerto Rico,2008,28871,30911,-2040,93.40040762
Hong Kong,1965,17621,18867,-1246,93.3958764
Japan,2004,1028602,1101430,-72828,93.3878685
Trinidad and Tobago,1974,6716,7192,-476,93.38153504
Hong Kong,2000,33989,36403,-2414,93.36867841
Kyrgyzstan,2009,35898,38450,-2552,93.36280884
Belarus,2018,120053,128588,-8535,93.36252216
South Africa,2010,543856,582529,-38673,93.36118889
South Africa,2008,592073,634342,-42269,93.33655977
Mauritius,1981,6404,6862,-458,93.32556106
Venezuela,1992,91593,98148,-6555,93.32131067
Dominica,1977,515,552,-37,93.29710145
Costa Rica,1986,10449,11200,-751,93.29464286
Lithuania,2019,38281,41043,-2762,93.27047243
Belarus,1987,99921,107164,-7243,93.2412004
Guatemala,1998,70504,75620,-5116,93.23459402
Hong Kong,2004,37321,40035,-2714,93.22093168
French Guiana,2006,726,779,-53,93.19640565
Moldova,2010,43631,46819,-3188,93.19079861
Colombia,1976,153966,165226,-11260,93.18509193
Brazil,2012,1181166,1267614,-86448,93.18025834
Thailand,2009,393747,422595,-28848,93.17360593
Sri Lanka,1997,114591,122998,-8407,93.16492951
Mauritius,1982,6385,6854,-469,93.15728042
Armenia,1995,24842,26667,-1825,93.15633555
Bulgaria,2004,110110,118212,-8102,93.14621189
Bulgaria,1988,107385,115290,-7905,93.14337757
Costa Rica,2003,15800,16967,-1167,93.12194259
Japan,2005,1083796,1164011,-80215,93.1087421
Guatemala,2011,72354,77720,-5366,93.09572826
Qatar,2011,1949,2094,-145,93.07545368
Hong Kong,2011,42188,45330,-3142,93.06860799
Saint Lucia,2003,1047,1125,-78,93.06666667
Hong Kong,1969,18729,20125,-1396,93.06335404
Bulgaria,1987,107213,115222,-8009,93.04907049
South Africa,2016,471955,507232,-35277,93.04519431
Mauritius,1977,6966,7487,-521,93.04127154
Kuwait,1981,4678,5028,-350,93.0389817
Panama,2008,15115,16248,-1133,93.02683407
Kyrgyzstan,2016,33475,35985,-2510,93.02487147
Hong Kong,2013,43399,46654,-3255,93.02310627
Luxembourg,2019,4008,4309,-301,93.01462056
French Guiana,1974,385,414,-29,92.99516908
Venezuela,1993,93411,100458,-7047,92.98512811
Colombia,1968,169083,181890,-12807,92.95893122
Dominica,1996,607,653,-46,92.95558959
Greece,1975,80077,86152,-6075,92.94850961
Albania,2004,17748,19095,-1347,92.94579733
Thailand,2012,415141,446746,-31605,92.92551025
Japan,2006,1084450,1167291,-82841,92.90314069
Uruguay,1963,23520,25319,-1799,92.89466409
Bulgaria,1989,106902,115087,-8185,92.88798909
Turkey,2013,357533,384967,-27434,92.87367489
Egypt,2011,493069,530966,-37897,92.86263151
Iceland,2021,2332,2512,-180,92.8343949
Cuba,1984,59801,64419,-4618,92.83130753
Kazakhstan,2021,182403,196490,-14087,92.83067841
Greece,1970,74009,79732,-5723,92.82220438
Bosnia and Herzegovina,2017,37979,40917,-2938,92.81961043
Trinidad and Tobago,1981,7354,7924,-570,92.8066633
Philippines,2014,536999,578645,-41646,92.80284112
Bulgaria,2003,111927,120653,-8726,92.76768916
Guatemala,2012,72657,78328,-5671,92.75993259
Barbados,2004,2306,2486,-180,92.75945294
Japan,2007,1108334,1194942,-86608,92.75211684
Qatar,2010,1970,2124,-154,92.74952919
Kyrgyzstan,2017,33166,35759,-2593,92.74867865
South Africa,2006,607184,654889,-47705,92.71555943
Panama,2011,16367,17654,-1287,92.70986745
Costa Rica,1984,9931,10712,-781,92.70911128
Armenia,2018,25751,27777,-2026,92.70619577
South Africa,2007,601133,648440,-47307,92.70449078
Hong Kong,2009,41047,44286,-3239,92.68617622
Panama,2009,15498,16721,-1223,92.68584415
Guatemala,1994,74761,80663,-5902,92.68313849
Guatemala,1968,79421,85700,-6279,92.67327888
South Africa,2011,514486,555206,-40720,92.66578531
Sri Lanka,1964,95618,103191,-7573,92.66118169
Panama,2019,20049,21641,-1592,92.64359318
Japan,2008,1142407,1233341,-90934,92.62701881
Puerto Rico,2012,29665,32040,-2375,92.58739076
Belize,2006,1395,1507,-112,92.56801593
Sri Lanka,1999,115330,124622,-9292,92.54385261
Argentina,1982,232638,251391,-18753,92.54030574
Puerto Rico,1970,18080,19540,-1460,92.52814739
Belize,2007,1386,1498,-112,92.52336449
South Africa,2012,491100,530829,-39729,92.51566889
Mexico,2003,470692,508888,-38196,92.4942227
Cuba,2003,78434,84808,-6374,92.4841996
Croatia,1991,54832,59288,-4456,92.48414519
Kyrgyzstan,2002,35235,38109,-2874,92.45847438
Kyrgyzstan,1998,34596,37420,-2824,92.45323356
Argentina,1985,239181,258730,-19549,92.4442469
Trinidad and Tobago,1971,7044,7620,-576,92.44094488
Paraguay,2016,31315,33876,-2561,92.44007557
Saint Kitts and Nevis,1990,464,502,-38,92.43027888
Japan,2009,1141865,1235455,-93590,92.42465327
Guatemala,1991,72896,78875,-5979,92.41965135
Barbados,1992,2365,2559,-194,92.41891364
Thailand,2018,461818,499760,-37942,92.40795582
El Salvador,2015,40869,44230,-3361,92.40108524
Japan,2010,1197012,1295676,-98664,92.38513332
El Salvador,2017,39835,43135,-3300,92.34960009
Dominica,1972,543,588,-45,92.34693878
Bulgaria,2002,112617,121957,-9340,92.34156301
Guatemala,2004,66876,72426,-5550,92.33700605
Guatemala,2003,66612,72144,-5532,92.33200266
Japan,2011,1253066,1357134,-104068,92.33178153
Georgia,2006,42255,45767,-3512,92.32634868
Bulgaria,2001,112368,121751,-9383,92.29328712
Trinidad and Tobago,1962,6465,7005,-540,92.29122056
Mauritius,1985,6691,7253,-562,92.25148215
Martinique,1975,2190,2374,-184,92.24936816
Puerto Rico,2006,28206,30588,-2382,92.2126324
Philippines,2009,480789,521392,-40603,92.2125771
Bahamas,1980,1311,1422,-111,92.19409283
Sri Lanka,1981,88481,95973,-7492,92.19363779
Dominica,1962,661,717,-56,92.18967922
Puerto Rico,2009,29004,31472,-2468,92.1581088
Venezuela,1989,84886,92120,-7234,92.14719931
Japan,2013,1268436,1376554,-108118,92.14574946
Cuba,2012,89372,96990,-7618,92.14558202
Venezuela,1979,73685,79968,-6283,92.14310724
Japan,2012,1256359,1363506,-107147,92.14180209
Guatemala,2000,67135,72863,-5728,92.1386712
Hong Kong,2002,34316,37246,-2930,92.13338345
Brazil,2009,1103088,1197320,-94232,92.12975646
Belarus,1986,97276,105589,-8313,92.12702081
Guyana,2005,5232,5680,-448,92.11267606
Mexico,2005,493957,536265,-42308,92.11061695
Mexico,1998,444665,482794,-38129,92.10242878
Bulgaria,1990,108608,117953,-9345,92.07735284
Egypt,2009,476591,517613,-41022,92.07477401
Guatemala,1993,73870,80230,-6360,92.07279073
Luxembourg,2018,4003,4348,-345,92.06531739
Moldova,2009,42139,45777,-3638,92.0527776
South Africa,2017,459083,498721,-39638,92.05206919
Grenada,2017,880,956,-76,92.05020921
Guatemala,1965,74830,81300,-6470,92.04182042
Kazakhstan,2001,147547,160339,-12792,92.02190359
Guatemala,2007,68394,74335,-5941,92.00780252
Kuwait,1993,3441,3740,-299,92.00534759
Bahamas,2001,1745,1897,-152,91.98734844
Venezuela,1978,72470,78788,-6318,91.98101234
Hong Kong,2001,33305,36210,-2905,91.97735432
Kuwait,1975,4778,5195,-417,91.97305101
Guyana,2007,5026,5465,-439,91.96706313
Venezuela,1986,78436,85322,-6886,91.92939687
Japan,2014,1273004,1384931,-111927,91.91822553
Cuba,1976,52907,57566,-4659,91.90668103
Colombia,1972,160380,174530,-14150,91.89251132
Mexico,2010,578572,629665,-51093,91.88568525
Maldives,2003,1006,1095,-89,91.87214612
Japan,2015,1290444,1405072,-114628,91.84184156
Cuba,1979,55170,60073,-4903,91.83826345
Venezuela,1987,80991,88191,-7200,91.83590162
Egypt,2013,511183,556632,-45449,91.8350005
Kuwait,1978,4936,5375,-439,91.83255814
Puerto Rico,2010,29150,31746,-2596,91.82259182
Venezuela,2015,168258,183274,-15016,91.80680293
French Guiana,2007,704,767,-63,91.78617992
Bulgaria,2000,115087,125462,-10375,91.73056384
Thailand,1995,324842,354185,-29343,91.7153465
Armenia,1992,25825,28158,-2333,91.71461041
Colombia,1975,153238,167106,-13868,91.70107596
Bosnia and Herzegovina,2018,37744,41164,-3420,91.69176951
Kazakhstan,1999,145792,159003,-13211,91.69135174
Venezuela,1996,100045,109152,-9107,91.65658898
Bulgaria,1999,111786,121975,-10189,91.6466489
Turkmenistan,1986,27865,30407,-2542,91.64008288
Saint Kitts and Nevis,2006,372,406,-34,91.62561576
South Korea,1993,217154,237023,-19869,91.61726921
Kazakhstan,2004,152250,166195,-13945,91.60925419
Costa Rica,1983,9432,10296,-864,91.60839161
Saint Kitts and Nevis,2003,371,405,-34,91.60493827
Greece,1971,73819,80600,-6781,91.58684864
Japan,2016,1307748,1428060,-120312,91.5751439
Japan,2017,1340397,1463873,-123476,91.56511528
French Guiana,2016,901,984,-83,91.56504065
Mexico,2002,457680,499949,-42269,91.54533762
South Africa,2005,591213,645838,-54625,91.5419966
Mexico,1997,440259,480966,-40707,91.53640798
Panama,2004,13474,14721,-1247,91.52910808
Cuba,1983,58348,63775,-5427,91.49039592
Bulgaria,1991,110423,120713,-10290,91.47564885
Saint Kitts and Nevis,1973,525,574,-49,91.46341463
Philippines,2010,488255,533882,-45627,91.45372948
Dominica,1975,481,526,-45,91.44486692
Kyrgyzstan,2018,32989,36078,-3089,91.43799545
Egypt,2008,466381,510054,-43673,91.43757328
Guatemala,2002,65985,72168,-6183,91.43249085
Guatemala,1992,73124,79982,-6858,91.42557075
Seychelles,2001,554,606,-52,91.41914191
Malta,1982,3096,3387,-291,91.40832595
Greece,1973,77648,84954,-7306,91.40005179
Ecuador,1972,67837,74224,-6387,91.39496659
Brazil,2008,1075141,1176400,-101259,91.39246855
Armenia,1994,24652,26974,-2322,91.39171054
Mauritius,1986,6622,7246,-624,91.38835219
Hong Kong,1989,28478,31163,-2685,91.38401309
Colombia,1957,173873,190300,-16427,91.36784025
Cuba,2011,87044,95281,-8237,91.35504455
Kazakhstan,2013,136261,149156,-12895,91.35468905
Bulgaria,1998,118190,129378,-11188,91.35247105
Mexico,1999,443950,486055,-42105,91.33740009
Cuba,1981,57941,63455,-5514,91.31037743
Chile,2019,109658,120100,-10442,91.30557868
Dominica,1998,595,652,-57,91.25766871
Barbados,2010,2265,2482,-217,91.25705077
Greece,1974,76303,83616,-7313,91.25406621
Reunion,2004,3880,4252,-372,91.25117592
Japan,2018,1362470,1493140,-130670,91.2486438
Philippines,2011,498441,546246,-47805,91.2484485
Reunion,2007,3981,4363,-382,91.2445565
Saint Lucia,1998,965,1058,-93,91.20982987
Panama,2003,13248,14528,-1280,91.18942731
Armenia,2001,24003,26324,-2321,91.18295092
Puerto Rico,1971,18144,19901,-1757,91.17129792
Albania,1993,16639,18251,-1612,91.16760725
Bahamas,1997,1670,1832,-162,91.15720524
Saint Vincent and the Grenadines,2019,969,1063,-94,91.15710254
Bulgaria,1993,109540,120170,-10630,91.15419822
Costa Rica,2002,15004,16464,-1460,91.13216715
Trinidad and Tobago,1970,6956,7636,-680,91.09481404
Costa Rica,2006,16641,18270,-1629,91.08374384
Bulgaria,1994,111787,122734,-10947,91.08071113
Qatar,2015,2185,2399,-214,91.07961651
Egypt,2003,437038,479852,-42814,91.07766561
Moldova,1985,46075,50591,-4516,91.0735111
Hong Kong,1988,27370,30054,-2684,91.0694084
Bulgaria,1992,107998,118597,-10599,91.06301171
French Guiana,1979,438,481,-43,91.06029106
Bulgaria,1997,121861,133841,-11980,91.04908063
Barbados,1983,2000,2197,-197,91.03322713
Armenia,1998,23210,25497,-2287,91.03031729
Moldova,1982,41046,45094,-4048,91.02319599
Armenia,1997,23985,26352,-2367,91.01775956
Mexico,2020,1069958,1175636,-105678,91.0109932
Trinidad and Tobago,1978,6824,7498,-674,91.01093625
Bulgaria,1995,114670,126008,-11338,91.00215859
Colombia,2018,236932,260364,-23432,91.0002919
Albania,1996,16747,18404,-1657,90.9965225
Barbados,1987,2181,2397,-216,90.98873592
Trinidad and Tobago,1951,7814,8588,-774,90.98742431
Armenia,2000,24025,26411,-2386,90.96588543
Luxembourg,2020,4348,4780,-432,90.9623431
Egypt,2002,419533,461231,-41698,90.95941079
Puerto Rico,2015,28084,30876,-2792,90.9573779
Venezuela,1997,98011,107758,-9747,90.9547319
Hong Kong,2006,37415,41137,-3722,90.95218417
Saint Vincent and the Grenadines,1997,743,817,-74,90.94247246
Puerto Rico,2013,29009,31902,-2893,90.93160303
Japan,2019,1381093,1519227,-138134,90.90761288
Greece,1972,76859,84547,-7688,90.90683289
Hong Kong,1990,29196,32120,-2924,90.89663761
Philippines,2008,461581,507902,-46321,90.87993353
Mauritius,1988,6699,7372,-673,90.87086272
Venezuela,1988,81605,89819,-8214,90.8549416
Antigua and Barbuda,1993,457,503,-46,90.85487078
Moldova,1981,41476,45654,-4178,90.84855653
South Africa,2003,552824,608547,-55723,90.84327094
Cuba,2007,81927,90186,-8259,90.84225933
Chile,2018,106796,117566,-10770,90.8391882
Japan,2020,1372755,1511209,-138454,90.83819644
Colombia,2010,200522,220750,-20228,90.83669309
Colombia,1958,173681,191205,-17524,90.8349677
Kyrgyzstan,2004,35062,38606,-3544,90.82007978
Hong Kong,1999,33382,36757,-3375,90.81807547
Turkmenistan,1998,29696,32699,-3003,90.81623291
Bulgaria,1996,117056,128898,-11842,90.81289081
Mexico,1996,436185,480313,-44128,90.81265758
Cuba,2006,80831,89018,-8187,90.80298367
Guatemala,1963,71449,78696,-7247,90.79114567
Turkmenistan,1997,30301,33383,-3082,90.76775604
Chile,2020,126169,139021,-12852,90.75535351
Thailand,1994,305526,336655,-31129,90.75344195
Guatemala,1966,75774,83499,-7725,90.7483922
Colombia,2008,196748,216895,-20147,90.71117361
Cuba,1980,55801,61528,-5727,90.69204265
Mexico,1976,454112,500754,-46642,90.68564605
Costa Rica,2016,22344,24642,-2298,90.67445824
Bahamas,1995,1604,1769,-165,90.67269644
Mexico,2004,471679,520537,-48858,90.6139237
Venezuela,1971,70457,77760,-7303,90.60828189
Mauritius,1987,6581,7264,-683,90.59746696
Moldova,2008,41948,46304,-4356,90.59260539
Guyana,2004,5141,5675,-534,90.59030837
Cuba,1974,52898,58393,-5495,90.58962547
Bahamas,1972,1100,1215,-115,90.53497942
Saint Kitts and Nevis,1998,410,453,-43,90.50772627
Mauritius,1983,6322,6989,-667,90.45643154
Barbados,2002,2240,2477,-237,90.43197416
Dominica,2002,594,657,-63,90.4109589
Dominica,1995,584,646,-62,90.40247678
Albania,2005,17427,19280,-1853,90.38900415
Hong Kong,1978,22843,25274,-2431,90.38141964
Colombia,2019,244355,270504,-26149,90.33322982
Barbados,1984,2027,2244,-217,90.32976827
Kyrgyzstan,1997,34540,38240,-3700,90.32426778
Colombia,2009,196683,217753,-21070,90.3238991
Costa Rica,2010,18988,21026,-2038,90.30723866
South Africa,2004,567487,628420,-60933,90.30377773
Philippines,2006,440996,488435,-47439,90.28755106
Venezuela,1998,100963,111831,-10868,90.28176445
Mexico,2011,576662,638875,-62213,90.26210135
Sri Lanka,1965,91728,101633,-9905,90.25414973
Bahamas,2005,1824,2021,-197,90.25235032
Colombia,2002,192074,212844,-20770,90.24167935
Armenia,1999,24087,26695,-2608,90.23038022
Costa Rica,2020,25996,28817,-2821,90.21063955
Guyana,2008,5003,5547,-544,90.19289706
Bahamas,1994,1539,1707,-168,90.15817223
Moldova,2007,43050,47762,-4712,90.13441648
Kazakhstan,2020,161333,179002,-17669,90.12916057
Guyana,2006,5031,5582,-551,90.12898603
Romania,2005,262101,290851,-28750,90.11521363
Costa Rica,2011,18458,20485,-2027,90.10495485
Saint Vincent and the Grenadines,1986,619,687,-68,90.10189229
Moldova,1986,40437,44880,-4443,90.10026738
Antigua and Barbuda,1995,455,505,-50,90.0990099
Thailand,1998,310512,344686,-34174,90.08546909
Colombia,2015,219472,243633,-24161,90.08303473
Colombia,2017,227624,252689,-25065,90.08069208
Bosnia and Herzegovina,2016,36571,40609,-4038,90.05639144
Moldova,1987,40185,44634,-4449,90.0322624
Maldives,2001,1056,1173,-117,90.02557545
Guatemala,1970,77333,85904,-8571,90.02258335
Paraguay,2020,35263,39177,-3914,90.00944432
Guyana,2002,5072,5635,-563,90.00887311
South Africa,2018,452345,502601,-50256,90.00081576
Mexico,2012,587826,653197,-65371,89.99214632
Mexico,2008,536335,596032,-59697,89.98426259
Moldova,1988,40912,45466,-4554,89.9837241
Brunei,2002,1041,1157,-116,89.97407087
Moldova,1989,40113,44584,-4471,89.97173874
Barbados,1991,2280,2535,-255,89.9408284
Colombia,2016,223078,248057,-24979,89.93013702
Saint Kitts and Nevis,2005,356,396,-40,89.8989899
Malta,1996,2765,3076,-311,89.88946684
Uruguay,1960,22100,24591,-2491,89.87027774
Costa Rica,1969,11599,12907,-1308,89.86596421
Hong Kong,1992,30525,33971,-3446,89.85605369
Venezuela,2014,162125,180453,-18328,89.84333871
Colombia,2006,192814,214631,-21817,89.83511236
Barbados,1990,2262,2518,-256,89.83320095
Egypt,2007,452831,504080,-51249,89.8331614
Saint Lucia,2019,1294,1441,-147,89.79875087
Costa Rica,1982,9168,10211,-1043,89.78552541
Colombia,2001,191372,213177,-21805,89.77141061
Singapore,2000,14715,16392,-1677,89.76939971
Mexico,1995,430101,479154,-49053,89.76258155
Brazil,2007,1047827,1167420,-119593,89.75578626
Bosnia and Herzegovina,1987,29382,32743,-3361,89.73521058
Brunei,2001,1014,1130,-116,89.73451327
Trinidad and Tobago,1953,7262,8094,-832,89.72078083
Saint Kitts and Nevis,2001,375,418,-43,89.71291866
Saint Kitts and Nevis,2008,374,417,-43,89.6882494
Kyrgyzstan,2000,34113,38037,-3924,89.683729
Ecuador,1973,65867,73445,-7578,89.68207502
Turkmenistan,1989,27609,30787,-3178,89.67746127
Antigua and Barbuda,1998,451,503,-52,89.66202783
Kazakhstan,2002,148700,165899,-17199,89.6328489
Colombia,2020,300853,335656,-34803,89.63134876
Mauritius,1975,6967,7773,-806,89.63077319
El Salvador,2016,38931,43438,-4507,89.62429209
Mexico,2014,618097,689666,-71569,89.62265792
Egypt,2004,433968,484286,-50318,89.60985864
Saint Kitts and Nevis,1994,405,452,-47,89.60176991
Saint Kitts and Nevis,2014,412,460,-48,89.56521739
Sri Lanka,2005,132097,147508,-15411,89.55243105
Mexico,2009,550946,615243,-64297,89.54933254
Hong Kong,1998,32675,36490,-3815,89.54508084
Uruguay,1957,21713,24253,-2540,89.52706882
South Africa,2015,460236,514293,-54057,89.48906557
Guatemala,2008,67356,75279,-7923,89.47515243
Argentina,1967,184641,206385,-21744,89.46435061
Georgia,2005,40721,45517,-4796,89.46327746
Mexico,1989,421836,471608,-49772,89.44631982
Mauritius,1984,6417,7178,-761,89.39816105
Kazakhstan,2014,131895,147568,-15673,89.37913369
Turkmenistan,1988,27317,30574,-3257,89.34715772
Costa Rica,1970,11504,12877,-1373,89.33757863
Mexico,2000,437667,490035,-52368,89.31341639
Kyrgyzstan,1996,34562,38699,-4137,89.30980129
Saint Kitts and Nevis,2016,401,449,-48,89.30957684
Moldova,1990,42427,47513,-5086,89.29556121
Mexico,2001,441004,494017,-53013,89.26899277
Brazil,2006,1031696,1156144,-124448,89.23594293
Colombia,2003,189800,212707,-22907,89.23072583
Belarus,1989,103479,115971,-12492,89.22834157
Colombia,2000,187276,209911,-22635,89.21685857
Mexico,2013,596129,668396,-72267,89.18799634
Cuba,1969,55654,62407,-6753,89.1790985
Mexico,1990,421736,473031,-51295,89.15610182
Dominica,1970,583,654,-71,89.14373089
Philippines,2007,441913,495826,-53913,89.1266291
Albania,1998,16476,18487,-2011,89.12208579
Mexico,1966,424141,475946,-51805,89.11536183
Saint Vincent and the Grenadines,2020,1031,1157,-126,89.10976664
Egypt,2006,442057,496115,-54058,89.10373603
Kyrgyzstan,1999,32851,36874,-4023,89.08987362
Bosnia and Herzegovina,1989,30383,34105,-3722,89.08664419
Bahamas,1979,1240,1392,-152,89.08045977
Antigua and Barbuda,1994,448,503,-55,89.06560636
Sri Lanka,1998,112653,126493,-13840,89.05868309
Grenada,1996,641,720,-79,89.02777778
Mexico,2006,493296,554109,-60813,89.02508351
Kazakhstan,2015,131029,147198,-16169,89.01547575
Belize,2005,1369,1538,-169,89.01170351
Saint Kitts and Nevis,1995,405,455,-50,89.01098901
Mayotte,2012,453,509,-56,88.99803536
Turkmenistan,1991,27403,30794,-3391,88.98811457
South Africa,2002,499494,561305,-61811,88.98798336
French Guiana,2015,832,935,-103,88.98395722
Colombia,1977,145426,163447,-18021,88.97440761
Guatemala,1971,75223,84545,-9322,88.97391921
Ecuador,2000,56335,63332,-6997,88.95187267
Guyana,1977,5883,6615,-732,88.93424036
Guatemala,1974,70229,79001,-8772,88.89634308
Ecuador,1992,53430,60110,-6680,88.88704043
Saint Lucia,2012,1151,1295,-144,88.88030888
Kazakhstan,2009,142778,160646,-17868,88.87740747
Cuba,2002,73883,83136,-9253,88.87004426
South Korea,1992,208322,234518,-26196,88.82985528
Costa Rica,2017,22959,25856,-2897,88.79563738
Ecuador,1974,64278,72405,-8127,88.77563704
Mexico,2015,640890,721944,-81054,88.7728134
Sri Lanka,1963,91673,103272,-11599,88.76849485
Moldova,2005,44689,50345,-5656,88.76551793
Egypt,2001,406489,457943,-51454,88.76410383
Guadeloupe,1981,2091,2356,-265,88.75212224
Grenada,1992,638,719,-81,88.73435327
Belize,1999,1189,1340,-151,88.73134328
Dominica,1973,496,559,-63,88.72987478
Saint Kitts and Nevis,1970,488,550,-62,88.72727273
Guatemala,1979,71138,80233,-9095,88.66426533
Barbados,1988,2174,2453,-279,88.62617203
Ecuador,1991,53333,60197,-6864,88.59743841
Cuba,1982,56224,63462,-7238,88.59474961
Bosnia and Herzegovina,1988,29560,33367,-3807,88.59052357
Colombia,2007,191663,216353,-24690,88.58809446
Brazil,2004,1024069,1155996,-131927,88.58759027
Mexico,1977,448261,506071,-57810,88.57670169
Ecuador,1999,55877,63099,-7222,88.55449373
Barbados,1986,2090,2361,-271,88.52181279
Costa Rica,2018,23506,26579,-3073,88.43824072
Guatemala,1997,67691,76562,-8871,88.41331209
Dominica,1999,618,699,-81,88.41201717
Greece,1966,67912,76839,-8927,88.38220175
Georgia,2007,41178,46592,-5414,88.3799794
Venezuela,2012,148087,167622,-19535,88.34580186
Mauritius,1978,6400,7246,-846,88.32459288
Singapore,1998,14546,16469,-1923,88.32351691
Sri Lanka,1967,87877,99498,-11621,88.32036825
Mongolia,2020,15922,18030,-2108,88.30837493
Moldova,2018,37200,42140,-4940,88.27717133
Colombia,2004,188781,213860,-25079,88.27316936
Venezuela,2007,127459,144397,-16938,88.2698394
Brazil,2005,1006827,1140735,-133908,88.26125261
Costa Rica,2005,15519,17584,-2065,88.25636943
Cuba,1975,50957,57760,-6803,88.22195291
Bosnia and Herzegovina,1986,29127,33024,-3897,88.19949128
French Guiana,1976,381,432,-51,88.19444444
French Guiana,2009,702,796,-94,88.19095477
South Africa,2001,452896,513557,-60661,88.18806871
Qatar,2016,2207,2503,-296,88.17419097
Colombia,2005,188837,214241,-25404,88.1423257
Barbados,1981,1878,2131,-253,88.12763961
Bahamas,1985,1298,1473,-175,88.11948405
Saint Kitts and Nevis,1993,393,446,-53,88.11659193
Ecuador,2021,105248,119463,-14215,88.10091828
Albania,2000,16411,18628,-2217,88.09856131
Colombia,2014,210051,238498,-28447,88.07243667
Mexico,1974,433104,491830,-58726,88.05969542
South Africa,2014,453360,514865,-61505,88.05415012
Panama,1970,10225,11615,-1390,88.03271632
Mongolia,2016,16182,18382,-2200,88.03177021
Ecuador,1979,59951,68105,-8154,88.02731077
Turkmenistan,1981,24883,28274,-3391,88.00664922
Bahamas,2009,2021,2297,-276,87.98432738
Costa Rica,2012,18913,21498,-2585,87.97562564
Moldova,1995,52872,60108,-7236,87.961669
Romania,2003,266575,303087,-36512,87.95329394
Mexico,1967,420298,477932,-57634,87.94096231
Jamaica,2001,16019,18216,-2197,87.93917435
Egypt,2005,431638,490856,-59218,87.93576935
Greece,1965,67269,76504,-9235,87.92873575
Oman,2009,7098,8075,-977,87.90092879
Singapore,1999,14490,16489,-1999,87.87676633
Venezuela,2013,149876,170568,-20692,87.86876788
Saint Lucia,1999,956,1088,-132,87.86764706
Trinidad and Tobago,1954,6807,7747,-940,87.86627081
Paraguay,2019,32362,36847,-4485,87.8280457
Costa Rica,1964,12269,13978,-1709,87.7736443
Venezuela,2003,121864,138843,-16979,87.77107956
Moldova,2017,36769,41894,-5125,87.76674464
Bahamas,2000,1625,1852,-227,87.74298056
Moldova,1991,45852,52267,-6415,87.72648134
Oman,2014,7819,8914,-1095,87.71595243
Kuwait,1976,4661,5315,-654,87.69520226
Trinidad and Tobago,1972,6955,7932,-977,87.68280383
Costa Rica,1972,10855,12380,-1525,87.68174475
Mexico,2016,671536,765905,-94369,87.67875912
Mexico,1994,418908,478018,-59110,87.63435687
Singapore,1991,12910,14735,-1825,87.61452324
Turkmenistan,1987,26802,30591,-3789,87.61400412
Venezuela,1999,104625,119417,-14792,87.61315391
Oman,2016,8196,9355,-1159,87.61090326
Martinique,1971,2170,2477,-307,87.60597497
Mexico,1975,433926,495424,-61498,87.58679434
Singapore,1992,13298,15187,-1889,87.56173043
Guatemala,1999,64563,73744,-9181,87.55017357
Colombia,1999,183553,209686,-26133,87.53707925
Bosnia and Herzegovina,1990,29093,33240,-4147,87.52406739
Colombia,2012,199756,228230,-28474,87.52398896
Seychelles,1987,505,577,-72,87.52166378
Costa Rica,2013,19365,22127,-2762,87.51751254
Mexico,1988,411462,470257,-58795,87.49726214
Belize,2002,1284,1468,-184,87.46594005
Bosnia and Herzegovina,1991,30680,35082,-4402,87.45225472
Moldova,2016,38487,44013,-5526,87.44461864
Kazakhstan,2017,129009,147533,-18524,87.44416503
Mauritius,1976,6815,7794,-979,87.43905568
Costa Rica,2019,24292,27786,-3494,87.4253221
Brunei,2007,1174,1343,-169,87.41623232
Kazakhstan,2016,131231,150123,-18892,87.4156525
French Guiana,2013,762,872,-110,87.3853211
Turkmenistan,1992,27509,31486,-3977,87.36898939
Venezuela,2000,105948,121265,-15317,87.36898528
Jamaica,2000,15779,18061,-2282,87.3650407
Nicaragua,2020,33681,38555,-4874,87.35831928
Uzbekistan,1988,134688,154179,-19491,87.35820053
Colombia,2011,195823,224162,-28339,87.35780373
Moldova,2006,43137,49383,-6246,87.35192273
Saint Lucia,2010,1091,1249,-158,87.3498799
Colombia,1956,171984,196894,-24910,87.34852256
Guyana,2016,4977,5698,-721,87.34643735
Panama,1997,12219,13990,-1771,87.34095783
Hong Kong,1996,32045,36690,-4645,87.33987463
Venezuela,1970,68549,78500,-9951,87.32356688
Mexico,2007,502075,574989,-72914,87.31906176
Greece,1968,73309,83956,-10647,87.31835723
Mexico,1993,416029,476582,-60553,87.29431661
Ecuador,2020,115516,132366,-16850,87.2701449
Greece,1967,71975,82474,-10499,87.26992749
Albania,1995,16059,18402,-2343,87.26768829
Kazakhstan,1985,126786,145286,-18500,87.26649505
Guyana,2003,4986,5714,-728,87.25936297
Guyana,2018,5041,5778,-737,87.24472136
South Africa,2013,458933,526045,-67112,87.24215609
Seychelles,2020,668,766,-98,87.20626632
Cuba,1970,53761,61675,-7914,87.16822051
Greece,1961,63955,73385,-9430,87.14996253
Kazakhstan,1981,120974,138820,-17846,87.14450367
Reunion,2001,3695,4241,-546,87.12567791
Hong Kong,1997,32076,36816,-4740,87.12516297
Thailand,1997,298084,342155,-44071,87.11958031
Brunei,2000,965,1108,-143,87.09386282
Greece,1969,71825,82474,-10649,87.08805199
Greece,1963,66813,76733,-9920,87.07205505
Uzbekistan,1987,133781,153667,-19886,87.05903024
Colombia,2013,203071,233264,-30193,87.05629673
Ecuador,2002,55531,63789,-8258,87.0541943
Ecuador,1988,52732,60574,-7842,87.05385149
French Guiana,2014,780,896,-116,87.05357143
Maldives,2005,995,1143,-148,87.05161855
Kazakhstan,1988,126898,145820,-18922,87.02372788
Georgia,1985,46153,53035,-6882,87.02366362
Mexico,1963,412833,474550,-61717,86.99462649
Paraguay,2018,31258,35931,-4673,86.99451727
Saint Lucia,2008,1043,1199,-156,86.98915763
Greece,1962,66554,76517,-9963,86.97936406
Bahamas,2011,2117,2434,-317,86.97617091
Brazil,2003,1002312,1152752,-150440,86.9494913
Saint Kitts and Nevis,1978,466,536,-70,86.94029851
Ecuador,2001,55192,63484,-8292,86.93844118
Venezuela,2011,143020,164508,-21488,86.93802125
Greece,1964,69429,79867,-10438,86.93077241
Venezuela,2002,110293,126935,-16642,86.88935282
Guyana,1998,5065,5830,-765,86.87821612
Hong Kong,1993,30218,34792,-4574,86.85329961
South Africa,2000,413736,476555,-62819,86.81810074
Kazakhstan,2019,133128,153401,-20273,86.7843104
Bahamas,2010,2023,2332,-309,86.74957118
Bosnia and Herzegovina,1985,28966,33397,-4431,86.73234123
Dominica,1968,573,661,-88,86.68683812
Belize,2008,1301,1501,-200,86.67554963
Oman,2017,8483,9788,-1305,86.66734777
Guatemala,1987,66404,76631,-10227,86.6542261
Saint Vincent and the Grenadines,2000,701,809,-108,86.65018541
Kyrgyzstan,2001,32677,37714,-5037,86.644217
Saint Kitts and Nevis,2000,363,419,-56,86.63484487
Brunei,2016,1632,1884,-252,86.62420382
Panama,2001,12442,14364,-1922,86.61932609
Sao Tome and Principe,1985,1055,1218,-163,86.61740558
Philippines,2002,396297,457534,-61237,86.61585806
Seychelles,1986,498,575,-77,86.60869565
Kuwait,1972,4149,4791,-642,86.59987477
Guatemala,1980,71360,82419,-11059,86.58197746
Albania,2002,16248,18767,-2519,86.57750306
Singapore,2007,16044,18534,-2490,86.56523147
Ecuador,1989,51736,59778,-8042,86.54689016
Venezuela,2010,138504,160040,-21536,86.54336416
Bahamas,1987,1376,1590,-214,86.5408805
Saint Lucia,2020,1273,1471,-198,86.53976886
Ecuador,2018,71982,83179,-11197,86.53866962
Moldova,1992,44635,51586,-6951,86.52541387
Sri Lanka,1996,102766,118778,-16012,86.51938911
Mexico,1991,410425,474400,-63975,86.51454469
Mauritius,1968,7126,8237,-1111,86.51207964
Hong Kong,1991,28675,33150,-4475,86.50075415
Brunei,2017,1696,1961,-265,86.48648649
Kazakhstan,2018,130448,150852,-20404,86.4741601
Albania,2006,16935,19600,-2665,86.40306122
Ecuador,2019,73431,85030,-11599,86.35893214
Iran,2016,339805,393654,-53849,86.32072836
Singapore,2005,15285,17710,-2425,86.30717109
Georgia,1981,43961,50937,-6976,86.30465084
Belize,2004,1298,1504,-206,86.30319149
Sri Lanka,2014,128185,148541,-20356,86.29603948
Dominica,2016,647,750,-103,86.26666667
Ecuador,2005,56796,65859,-9063,86.23878285
Uzbekistan,1986,132213,153330,-21117,86.22774408
Cuba,1971,52299,60659,-8360,86.21803854
Hong Kong,1995,30892,35839,-4947,86.19660147
Mexico,1964,408275,473677,-65402,86.19270093
Mexico,1985,410937,476791,-65854,86.18807821
Dominica,2015,661,767,-106,86.17992177
Brunei,1998,928,1077,-149,86.16527391
Panama,1971,9857,11440,-1583,86.16258741
Ecuador,2006,57895,67199,-9304,86.15455587
Cuba,1973,51026,59239,-8213,86.13582268
Costa Rica,1980,9273,10768,-1495,86.11627043
Panama,2002,12428,14432,-2004,86.11419069
Ecuador,1998,54282,63041,-8759,86.10586761
Mexico,1992,409427,475508,-66081,86.10307292
Georgia,1986,46354,53841,-7487,86.09424045
Moldova,1993,46688,54229,-7541,86.09415626
Saint Lucia,2006,996,1157,-161,86.08470182
Turkmenistan,1985,26080,30297,-4217,86.08113014
Kuwait,2017,6679,7760,-1081,86.06958763
Brazil,2002,982794,1142124,-159330,86.04967587
Uruguay,1958,20932,24328,-3396,86.04077606
Syria,1999,61716,71759,-10043,86.00454298
Ecuador,1993,52453,60990,-8537,86.00262338
Guatemala,1986,66328,77129,-10801,85.9961882
Kyrgyzstan,1985,32332,37603,-5271,85.9825014
Uzbekistan,1994,148405,172610,-24205,85.97705811
Belize,2001,1261,1467,-206,85.95773688
Jamaica,1967,13136,15282,-2146,85.95733543
Singapore,2006,15414,17938,-2524,85.92931207
Costa Rica,1981,8990,10464,-1474,85.91360856
Mexico,1987,404699,471234,-66535,85.88068773
Kyrgyzstan,1993,34513,40207,-5694,85.83828687
Ecuador,1969,64472,75113,-10641,85.83334443
Georgia,1988,47544,55410,-7866,85.8040065
Bahamas,1999,1575,1836,-261,85.78431373
Uzbekistan,1993,145294,169419,-24125,85.76015677
Uzbekistan,1985,131686,153583,-21897,85.74256265
Sri Lanka,1962,88928,103718,-14790,85.7401801
Moldova,1994,52122,60798,-8676,85.72979374
Cuba,1968,53920,62901,-8981,85.7220076
El Salvador,2018,37469,43729,-6260,85.68455716
Kazakhstan,1982,120165,140266,-20101,85.66937105
Venezuela,2004,117218,136849,-19631,85.654992
Bahamas,2014,2159,2521,-362,85.6406188
Guatemala,1964,68278,79731,-11453,85.6354492
Brazil,2001,961482,1123125,-161643,85.60774624
Philippines,2003,396331,463177,-66846,85.56793623
Ecuador,2012,63511,74223,-10712,85.56781591
Thailand,1992,275313,321756,-46443,85.56577034
Turkmenistan,2015,32247,37687,-5440,85.5653143
Antigua and Barbuda,1985,397,464,-67,85.56034483
Mauritius,1966,6701,7834,-1133,85.53740107
Colombia,1996,173506,202850,-29344,85.53413853
Belize,2003,1277,1493,-216,85.53248493
Sri Lanka,2010,130337,152389,-22052,85.52913924
Brunei,2015,1547,1809,-262,85.51686014
Ecuador,1971,63906,74736,-10830,85.50899165
Kuwait,2016,6338,7414,-1076,85.48691664
Colombia,1992,167743,196248,-28505,85.47501121
Bahamas,1993,1441,1687,-246,85.4179016
Mongolia,2017,15812,18517,-2705,85.39180213
Moldova,2015,39906,46735,-6829,85.38782497
Venezuela,2008,133651,156541,-22890,85.3776327
Ecuador,1977,59150,69296,-10146,85.35846225
Guatemala,1981,71748,84059,-12311,85.35433446
Guyana,1997,5134,6015,-881,85.35328346
Uruguay,1955,20598,24135,-3537,85.34493474
Ecuador,2008,59950,70285,-10335,85.29558227
Turkmenistan,2014,31751,37229,-5478,85.2856644
Colombia,1993,168647,197750,-29103,85.282933
Singapore,2002,14908,17482,-2574,85.27628418
Saint Kitts and Nevis,2002,353,414,-61,85.26570048
South Africa,1998,365053,428229,-63176,85.2471458
Ecuador,2017,69247,81236,-11989,85.24176473
Egypt,1991,391588,459403,-67815,85.23845077
Mexico,1965,404163,474221,-70058,85.22671919
Singapore,2001,14449,16956,-2507,85.21467327
Brunei,2005,1072,1258,-186,85.21462639
Georgia,2000,41285,48466,-7181,85.18342756
Hong Kong,1994,30104,35344,-5240,85.17428701
Antigua and Barbuda,1992,425,499,-74,85.17034068
Brunei,2003,1010,1186,-176,85.16020236
French Guiana,1970,355,417,-62,85.13189448
Colombia,1987,151957,178536,-26579,85.11280638
Guyana,1995,5178,6084,-906,85.10848126
Colombia,1969,153878,180816,-26938,85.10198213
Venezuela,2005,117788,138428,-20640,85.08972173
Uzbekistan,1992,140092,164684,-24592,85.06715892
Costa Rica,1979,9143,10748,-1605,85.06698921
Costa Rica,1971,10575,12434,-1859,85.04905903
Kazakhstan,1987,122835,144458,-21623,85.03163549
French Guiana,2011,693,815,-122,85.03067485
Turkmenistan,2013,30510,35885,-5375,85.02159677
Paraguay,2015,28641,33698,-5057,84.99317467
Saint Lucia,1968,784,923,-139,84.9404117
Colombia,1998,175363,206553,-31190,84.89975938
Sao Tome and Principe,1987,1006,1185,-179,84.89451477
Antigua and Barbuda,1989,415,489,-74,84.86707566
Egypt,1966,477021,562220,-85199,84.84596777
Venezuela,2006,121673,143418,-21745,84.83802591
Guatemala,1984,66260,78145,-11885,84.79109348
Turkmenistan,2007,28536,33663,-5127,84.76962838
South Korea,1991,199673,235594,-35921,84.75300729
Bahamas,2015,2234,2636,-402,84.74962064
Qatar,1995,1000,1180,-180,84.74576271
Mexico,2017,688468,812498,-124030,84.73473165
Brazil,1999,938658,1107868,-169210,84.72651977
Brunei,2014,1470,1735,-265,84.72622478
Ecuador,2011,62304,73561,-11257,84.69705415
Ecuador,2010,61616,72749,-11133,84.69669686
Paraguay,2013,27692,32700,-5008,84.68501529
Sri Lanka,2013,127183,150208,-23025,84.67125586
Singapore,1993,13351,15772,-2421,84.65001268
Kazakhstan,1991,134572,159028,-24456,84.62157607
Colombia,1995,169896,200808,-30912,84.60619099
Mauritius,1970,6308,7456,-1148,84.60300429
Armenia,1991,23428,27696,-4268,84.58983247
Ecuador,1990,50217,59381,-9164,84.56745424
Turkmenistan,2011,28851,34116,-5265,84.56735842
Saint Kitts and Nevis,1992,389,460,-71,84.56521739
Ecuador,2016,67506,79828,-12322,84.56431327
Venezuela,2009,134733,159334,-24601,84.56010644
Colombia,1991,163692,193733,-30041,84.49360718
Mexico,1984,407278,482031,-74753,84.49207624
Brazil,1998,929023,1099585,-170562,84.48851157
Colombia,1994,168568,199584,-31016,84.45967613
Dominica,1982,406,481,-75,84.40748441
Ecuador,2007,57971,68682,-10711,84.4049387
Panama,1969,9791,11602,-1811,84.39062231
Kazakhstan,1989,126378,149766,-23388,84.38363848
Ecuador,2004,54697,64855,-10158,84.33736797
Costa Rica,1975,9615,11402,-1787,84.327311
South Africa,1999,380982,451828,-70846,84.32013952
Colombia,1986,146346,173581,-27235,84.30991871
Costa Rica,1965,11649,13817,-2168,84.30918434
Bahamas,2003,1649,1956,-307,84.30470348
Costa Rica,2015,20763,24629,-3866,84.30305737
Brunei,2006,1095,1299,-204,84.29561201
Ecuador,2013,63104,74876,-11772,84.2780063
Singapore,2003,15168,18000,-2832,84.26666667
Syria,2000,60675,72012,-11337,84.25679053
Turkmenistan,2002,27251,32356,-5105,84.22240079
Kazakhstan,1992,137705,163517,-25812,84.21448534
Mexico,1980,432547,513740,-81193,84.19570211
Philippines,2001,381834,453625,-71791,84.17393221
Ecuador,1980,57020,67769,-10749,84.13876551
Panama,1999,11972,14229,-2257,84.13802797
Guatemala,1977,65828,78257,-12429,84.11771471
Costa Rica,1976,9356,11124,-1768,84.10643653
Brazil,2000,946391,1125256,-178865,84.104506
Bahamas,2006,1730,2057,-327,84.10306271
Brunei,2013,1400,1665,-265,84.08408408
Mexico,2019,729057,867074,-138017,84.08244279
Turkmenistan,2010,28279,33638,-5359,84.06861288
Singapore,2008,16162,19225,-3063,84.06762029
Saint Kitts and Nevis,2011,374,445,-71,84.04494382
Ecuador,1996,52300,62237,-9937,84.03361345
Thailand,1991,264347,314636,-50289,84.01676858
Costa Rica,1967,11214,13349,-2135,84.00629261
Panama,1998,11862,14121,-2259,84.00254939
Costa Rica,1966,11379,13547,-2168,83.99645678
Philippines,1996,344363,410000,-65637,83.99097561
Bahamas,2008,1862,2217,-355,83.98737032
Syria,1998,59597,70963,-11366,83.98320251
Qatar,2004,1347,1604,-257,83.97755611
Turkmenistan,2005,28206,33597,-5391,83.95392446
Belize,1995,931,1109,-178,83.94950406
Guatemala,1967,71191,84803,-13612,83.94868106
Colombia,1988,153069,182343,-29274,83.94564091
Dominica,1967,528,629,-101,83.9427663
Saint Kitts and Nevis,2007,345,411,-66,83.94160584
Guatemala,1988,64100,76370,-12270,83.93348173
Venezuela,1969,67954,80992,-13038,83.90211379
Mauritius,1963,6709,7997,-1288,83.89396024
Mexico,1983,410860,489816,-78956,83.88047757
Mauritius,1965,6337,7555,-1218,83.87822634
Turkmenistan,1990,25755,30709,-4954,83.86792146
El Salvador,2014,37474,44685,-7211,83.86259371
Egypt,2000,382138,455708,-73570,83.85589018
Ecuador,2015,64790,77266,-12476,83.85318251
Saint Lucia,2017,1184,1412,-228,83.85269122
Belize,1976,871,1039,-168,83.83060635
Turkmenistan,2012,29208,34863,-5655,83.77936494
Saint Lucia,2002,940,1122,-182,83.77896613
Kazakhstan,1990,128787,153746,-24959,83.76608172
Paraguay,2017,29021,34651,-5630,83.75227266
Turkmenistan,2003,27135,32401,-5266,83.7474152
Guyana,1989,5389,6435,-1046,83.74514375
Singapore,1994,13870,16565,-2695,83.73075762
Mexico,1986,396561,473627,-77066,83.72854588
Ecuador,1994,51165,61123,-9958,83.70826039
Bahamas,2007,1798,2148,-350,83.70577281
Saint Kitts and Nevis,2009,354,423,-69,83.68794326
Georgia,1982,42734,51128,-8394,83.58238147
Dominica,1993,562,673,-111,83.50668648
Ecuador,1987,51567,61755,-10188,83.5025504
Colombia,1997,170532,204267,-33735,83.48485071
Costa Rica,2007,15938,19100,-3162,83.44502618
Brazil,1996,908882,1089847,-180965,83.39537568
Dominica,2004,557,668,-111,83.38323353
Bahamas,1981,1207,1448,-241,83.35635359
Turkmenistan,2009,27750,33296,-5546,83.34334455
Ecuador,2003,53482,64179,-10697,83.33255426
Philippines,1998,352992,423670,-70678,83.31767649
Uzbekistan,1982,124137,149002,-24865,83.31230453
Singapore,1997,14127,16958,-2831,83.30581436
Georgia,1987,46332,55645,-9313,83.26354569
Ecuador,2009,59629,71621,-11992,83.25630751
Turkmenistan,2006,27944,33572,-5628,83.23603003
Turkmenistan,2004,27067,32524,-5457,83.22162096
Ecuador,1968,61697,74158,-12461,83.19668815
Montenegro,2017,5484,6592,-1108,83.19174757
Belize,1978,871,1047,-176,83.19006686
Singapore,1996,14427,17345,-2918,83.17670799
Turkmenistan,1982,23984,28837,-4853,83.17092624
Uzbekistan,1995,145425,174870,-29445,83.16177732
Albania,1997,16182,19461,-3279,83.15091722
Colombia,1989,154694,186089,-31395,83.12904041
Kyrgyzstan,1988,31879,38351,-6472,83.12429924
Saint Kitts and Nevis,1986,413,497,-84,83.09859155
Ecuador,2014,62981,75818,-12837,83.06866443
Syria,2008,67028,80708,-13680,83.05000743
Syria,2002,58354,70276,-11922,83.03546019
Singapore,1995,14461,17416,-2955,83.03284336
Brunei,1999,905,1090,-185,83.02752294
Saint Lucia,2001,929,1119,-190,83.02055407
Iran,2015,327469,394524,-67055,83.00356886
Ecuador,1997,52054,62723,-10669,82.99029064
Saint Kitts and Nevis,1991,399,481,-82,82.95218295
Panama,2000,11867,14307,-2440,82.94541134
Mexico,1981,421762,508536,-86774,82.93650794
Egypt,1992,382465,461180,-78715,82.93182705
Mexico,2018,705149,850431,-145282,82.91666226
Brunei,2019,1757,2119,-362,82.91647003
Guyana,2001,4629,5583,-954,82.91241268
Mexico,1979,425976,513955,-87979,82.88196437
Qatar,2001,1210,1460,-250,82.87671233
Panama,1968,9568,11548,-1980,82.85417388
Costa Rica,2008,16478,19893,-3415,82.83315739
Brunei,1997,883,1066,-183,82.83302064
Bahamas,2004,1655,1998,-343,82.83283283
Moldova,2012,39560,47761,-8201,82.82908649
Costa Rica,2014,20290,24497,-4207,82.82646855
El Salvador,1998,29934,36147,-6213,82.81185161
Georgia,1989,47077,56907,-9830,82.7262024
Albania,2008,16143,19517,-3374,82.71250705
Guatemala,1976,83127,100524,-17397,82.69368509
Bahamas,2013,2065,2498,-433,82.66613291
Moldova,2014,39494,47778,-8284,82.66147599
Singapore,2004,14924,18057,-3133,82.64938805
Brunei,2004,1009,1221,-212,82.63718264
Uzbekistan,2017,160723,194513,-33790,82.62841044
Brazil,1997,903516,1093661,-190145,82.61389955
Costa Rica,1977,8907,10786,-1879,82.57926942
Martinique,1982,1891,2291,-400,82.54037538
Ecuador,1978,56601,68595,-11994,82.51476055
Saint Lucia,2016,1142,1384,-242,82.51445087
Moldova,2011,39249,47580,-8331,82.49054224
Mexico,1960,402545,488005,-85460,82.48788435
Qatar,2017,2185,2649,-464,82.48395621
Panama,1973,9173,11124,-1951,82.46134484
Antigua and Barbuda,1990,404,490,-86,82.44897959
Bahamas,1996,1503,1823,-320,82.44651673
Uzbekistan,1996,144829,175673,-30844,82.44237874
Jamaica,2002,14859,18028,-3169,82.42178833
Ecuador,1983,55202,66991,-11789,82.40211372
Guyana,2019,4976,6039,-1063,82.39774797
Albania,1999,15300,18571,-3271,82.38651661
Costa Rica,1973,9702,11777,-2075,82.38091195
Maldives,2004,991,1203,-212,82.37738986
Ecuador,1995,50867,61751,-10884,82.3743745
Costa Rica,2009,16652,20216,-3564,82.37039968
Antigua and Barbuda,1991,405,492,-87,82.31707317
Mauritius,1969,6428,7810,-1382,82.30473752
Romania,2004,258890,314595,-55705,82.29310701
Cuba,1972,49447,60097,-10650,82.27864952
Costa Rica,1978,8625,10483,-1858,82.27606601
Philippines,1968,253841,308568,-54727,82.26420108
Dominica,1986,487,592,-105,82.26351351
Armenia,1990,21993,26756,-4763,82.19838541
Guyana,2009,4562,5551,-989,82.18339038
Saint Lucia,2013,1093,1330,-237,82.18045113
Colombia,1955,161863,196985,-35122,82.17021601
Uruguay,1956,19876,24197,-4321,82.14241435
Mexico,1982,409777,499114,-89337,82.10088276
Philippines,2000,366931,447028,-80097,82.08233041
Turkey,2012,320967,391087,-70120,82.0704856
Paraguay,2010,26173,31898,-5725,82.05216628
Dominica,1978,416,507,-91,82.05128205
Mexico,1957,414545,505265,-90720,82.04506546
Mauritius,1973,6525,7953,-1428,82.04451151
Panama,1974,9015,10995,-1980,81.99181446
Colombia,1984,137189,167428,-30239,81.93910218
Antigua and Barbuda,1987,390,476,-86,81.93277311
Dominica,2006,539,658,-119,81.91489362
Colombia,1953,163653,199936,-36283,81.85269286
Uzbekistan,1989,126862,155122,-28260,81.7820812
Antigua and Barbuda,2000,404,494,-90,81.78137652
Moldova,2004,41668,50971,-9303,81.74844519
Ecuador,1966,59618,72933,-13315,81.74351802
Turkmenistan,2000,25978,31782,-5804,81.73809074
Thailand,1990,252512,309013,-56501,81.71565598
Philippines,1997,339400,415356,-75956,81.71303653
Guatemala,1995,65159,79743,-14584,81.71124738
Bosnia and Herzegovina,2014,35980,44049,-8069,81.68176349
Moldova,2003,43079,52745,-9666,81.67409233
Mauritius,1972,6506,7970,-1464,81.63111669
Albania,1994,14984,18357,-3373,81.62553794
Georgia,2001,39339,48214,-8875,81.59248351
Mauritius,1971,6248,7659,-1411,81.5772294
Kazakhstan,1986,119149,146087,-26938,81.56030311
Brazil,1994,884879,1085065,-200186,81.55078267
Kyrgyzstan,1989,31156,38205,-7049,81.5495354
Saint Lucia,2015,1103,1353,-250,81.5225425
Brunei,2009,1171,1437,-266,81.48921364
Jamaica,1987,13800,16939,-3139,81.46879981
Brazil,1995,890258,1093164,-202906,81.43864964
Bahamas,1975,1006,1236,-230,81.39158576
Mexico,1978,416424,511642,-95218,81.38972172
Georgia,1999,40378,49611,-9233,81.38920804
South Korea,1990,191005,234766,-43761,81.35973693
Ecuador,1981,54909,67491,-12582,81.35751434
Brunei,2010,1208,1485,-277,81.34680135
Martinique,1981,1862,2290,-428,81.31004367
Colombia,1990,154685,190271,-35586,81.29720241
Georgia,1991,46475,57173,-10698,81.28837038
Philippines,1969,255785,314970,-59185,81.20932152
Armenia,1989,20853,25681,-4828,81.20010903
Costa Rica,1968,10653,13124,-2471,81.17189881
Oman,2019,8332,10267,-1935,81.15320931
Costa Rica,1963,11376,14021,-2645,81.1354397
Sri Lanka,2012,122741,151293,-28552,81.12800989
Guyana,1979,5410,6670,-1260,81.10944528
Seychelles,1985,468,577,-109,81.10918544
Mexico,1958,404529,498762,-94233,81.10661999
Dominica,1992,566,698,-132,81.08882521
Panama,1966,9184,11329,-2145,81.06629005
Costa Rica,1974,9512,11738,-2226,81.03595161
Albania,2001,15143,18695,-3552,81.00026745
Syria,2010,67024,82765,-15741,80.98109104
South Korea,1985,200062,247294,-47232,80.90046665
Singapore,2013,17810,22020,-4210,80.88101726
Singapore,2009,16013,19809,-3796,80.83699329
Egypt,1970,480982,595100,-114118,80.8237271
Panama,1996,11197,13858,-2661,80.79809496
Mexico,1961,388857,481373,-92516,80.78080823
Philippines,1965,241305,298746,-57441,80.77262959
Ecuador,1970,60495,74935,-14440,80.72996597
Ecuador,1984,53118,65805,-12687,80.72031001
Guatemala,1978,63998,79320,-15322,80.68330812
Paraguay,2014,26975,33437,-6462,80.67410354
Brazil,1993,876145,1086137,-209992,80.66615906
Ecuador,1986,50957,63177,-12220,80.65751777
Panama,1972,9097,11281,-2184,80.64001418
Brunei,2011,1235,1532,-297,80.61357702
Uzbekistan,2002,137028,170055,-33027,80.57863632
Jamaica,2003,14609,18136,-3527,80.55249228
Mauritius,1964,6184,7677,-1493,80.55229908
Mexico,1959,396924,492873,-95949,80.5327133
Panama,1963,8921,11078,-2157,80.52897635
El Salvador,1997,29134,36179,-7045,80.52737776
Kyrgyzstan,1992,32164,39944,-7780,80.52273182
Uzbekistan,1998,140526,174543,-34017,80.51081968
Oman,2018,8091,10054,-1963,80.47543266
Bahamas,2012,1993,2477,-484,80.46023415
Saint Lucia,2018,1141,1419,-278,80.40873855
Venezuela,1968,64572,80349,-15777,80.36441026
Antigua and Barbuda,1962,405,504,-99,80.35714286
Georgia,1990,45945,57177,-11232,80.35573745
Turkmenistan,2001,25840,32158,-6318,80.3532558
Cape Verde,2011,2521,3138,-617,80.33779477
Colombia,1985,153947,191701,-37754,80.3057887
Georgia,1992,46684,58142,-11458,80.29307557
Uzbekistan,1991,130294,162275,-31981,80.29209675
Dominica,2008,545,679,-134,80.26509573
Philippines,1999,348028,433612,-85584,80.26253886
Uzbekistan,2003,135933,169366,-33433,80.25991049
Singapore,2010,16475,20528,-4053,80.25623539
Uzbekistan,2005,140585,175394,-34809,80.1538251
Philippines,1966,240865,300628,-59763,80.12061418
Singapore,2012,17273,21561,-4288,80.11223969
Jamaica,1985,13860,17305,-3445,80.09245883
Singapore,2011,16887,21086,-4199,80.08631319
Kyrgyzstan,1987,30597,38207,-7610,80.08218389
Sri Lanka,2011,123183,153831,-30648,80.07683757
El Salvador,2001,29574,36945,-7371,80.04872107
Nicaragua,2016,23738,29656,-5918,80.04451039
Bahamas,1984,1139,1423,-284,80.04216444
Guatemala,1989,61548,76895,-15347,80.04161519
Kyrgyzstan,1981,29591,36971,-7380,80.03840848
Azerbaijan,2004,49568,61935,-12367,80.03229192
Uzbekistan,2016,154791,193460,-38669,80.01188876
Singapore,2014,18237,22809,-4572,79.95528081
Venezuela,2001,110528,138279,-27751,79.93115368
Dominica,1997,513,642,-129,79.90654206
El Salvador,2000,28167,35323,-7156,79.74124508
Jamaica,2004,14394,18053,-3659,79.73190052
Paraguay,2011,25696,32233,-6537,79.71954208
Dominica,2003,557,699,-142,79.68526466
Moldova,2013,38060,47772,-9712,79.67009964
Egypt,1972,479240,601823,-122583,79.63138664
Azerbaijan,2003,49379,62027,-12648,79.60888
El Salvador,2009,32872,41304,-8432,79.5855123
Antigua and Barbuda,1986,374,470,-96,79.57446809
El Salvador,1999,28078,35296,-7218,79.55009066
Dominica,1994,529,665,-136,79.54887218
Dominica,1985,466,586,-120,79.5221843
Saint Kitts and Nevis,2013,353,444,-91,79.5045045
Philippines,1967,241548,303846,-62298,79.49685038
Uzbekistan,1981,117793,148228,-30435,79.46744205
Nicaragua,2017,23826,29983,-6157,79.46503018
Saint Lucia,2009,974,1226,-252,79.44535073
Panama,1975,8693,10947,-2254,79.40988399
Philippines,1995,324737,409301,-84564,79.33941036
Guyana,1996,4811,6064,-1253,79.33707124
Philippines,1994,321440,405162,-83722,79.33616677
Paraguay,2009,25079,31617,-6538,79.32125123
Syria,2006,57160,72078,-14918,79.30297733
Ecuador,1967,58317,73547,-15230,79.29215332
Azerbaijan,2007,50439,63623,-13184,79.27793408
Saint Kitts and Nevis,2015,371,468,-97,79.27350427
Mexico,1962,378104,477192,-99088,79.23519254
Turkmenistan,1999,25578,32283,-6705,79.23055478
Singapore,2015,18640,23533,-4893,79.20792079
Paraguay,2012,25657,32412,-6755,79.15895347
Ecuador,1985,51134,64605,-13471,79.1486727
Maldives,2000,996,1259,-263,79.11040508
Uzbekistan,1990,124553,157484,-32931,79.08930431
Maldives,2019,1132,1432,-300,79.05027933
Grenada,2001,606,767,-161,79.00912647
Uzbekistan,2012,145988,184821,-38833,78.98885949
Uzbekistan,2015,152035,192576,-40541,78.94805168
Brunei,2018,1612,2042,-430,78.94221352
Bahamas,1983,1104,1399,-295,78.91350965
Mauritius,1961,6505,8244,-1739,78.90587094
Uzbekistan,2000,135598,171848,-36250,78.9057772
Qatar,2020,2734,3465,-731,78.9033189
Ecuador,1982,53009,67220,-14211,78.85897054
Jamaica,1984,13706,17381,-3675,78.85622231
Belize,1980,815,1034,-219,78.82011605
Dominica,1980,387,491,-104,78.81873727
Syria,2009,63336,80361,-17025,78.81435024
Mauritius,1974,6221,7898,-1677,78.7667764
Nicaragua,2019,24317,30875,-6558,78.75951417
Jamaica,1983,13646,17342,-3696,78.68757929
Kyrgyzstan,1991,30859,39251,-8392,78.619653
Mauritius,1967,6543,8324,-1781,78.60403652
Philippines,1993,318546,405375,-86829,78.58057354
Brunei,2008,1091,1389,-298,78.54571634
Saint Kitts and Nevis,1971,439,559,-120,78.53309481
Barbados,1982,1723,2194,-471,78.53236098
Dominica,2007,567,722,-155,78.53185596
Singapore,2017,19763,25169,-5406,78.52119671
Uzbekistan,2011,143253,182466,-39213,78.50942093
El Salvador,2010,32586,41506,-8920,78.50913121
Brazil,1988,833369,1061700,-228331,78.49383065
Nicaragua,2014,22449,28600,-6151,78.49300699
Uzbekistan,2014,149761,190796,-41035,78.4927357
Dominica,1984,427,544,-117,78.49264706
Thailand,1987,232968,296854,-63886,78.47898293
Philippines,1992,319579,407560,-87981,78.41274904
Saint Kitts and Nevis,2010,344,439,-95,78.35990888
Egypt,1977,457558,584282,-126724,78.31115797
El Salvador,1996,28904,36911,-8007,78.30727967
Kyrgyzstan,1982,29194,37296,-8102,78.27649078
Belize,1996,887,1134,-247,78.21869489
Kyrgyzstan,1990,30580,39099,-8519,78.21171897
Sri Lanka,1960,84918,108578,-23660,78.20921365
Uzbekistan,2018,154913,198098,-43185,78.20018375
Kuwait,2018,6807,8708,-1901,78.16949931
Panama,1976,8578,10975,-2397,78.1594533
Panama,1967,8938,11437,-2499,78.14986447
Cyprus,2015,5887,7534,-1647,78.13910273
Syria,2007,58260,74566,-16306,78.13212456
South Africa,1997,316505,405333,-88828,78.08517935
El Salvador,2011,33162,42488,-9326,78.05027302
Syria,2005,56903,72918,-16015,78.03697304
Saint Kitts and Nevis,2012,341,437,-96,78.03203661
Albania,2009,15662,20073,-4411,78.02520799
Sri Lanka,2006,117467,150680,-33213,77.95792408
Uzbekistan,1997,137331,176403,-39072,77.85071682
Mexico,1955,407522,523892,-116370,77.78740656
South Korea,1986,191782,246614,-54832,77.76606356
Moldova,1996,50059,64372,-14313,77.76517741
Georgia,1998,39404,50677,-11273,77.75519466
Armenia,1985,19581,25191,-5610,77.73014172
Thailand,1983,252592,325063,-72471,77.70555246
Egypt,1979,444753,572435,-127682,77.6949348
El Salvador,1995,29161,37538,-8377,77.68394693
Panama,1965,8687,11185,-2498,77.66651766
Nicaragua,2018,23535,30313,-6778,77.63995645
Belize,1986,787,1014,-227,77.61341223
Guatemala,1996,60618,78106,-17488,77.60991473
Sri Lanka,2007,118992,153324,-34332,77.60820224
Panama,1959,8789,11335,-2546,77.53859727
Mayotte,2013,414,534,-120,77.52808989
Cyprus,2017,6033,7782,-1749,77.52505783
Sri Lanka,1961,81653,105368,-23715,77.49316681
Singapore,2016,18856,24353,-5497,77.4278323
Mauritius,1962,6325,8169,-1844,77.42685763
Turkey,2011,312249,403319,-91070,77.41985872
Qatar,2021,2741,3542,-801,77.38565782
Jamaica,1977,13006,16807,-3801,77.38442316
Singapore,2018,20095,25978,-5883,77.35391485
Costa Rica,1962,10861,14053,-3192,77.28598876
Suriname,2010,3002,3886,-884,77.25167267
Ecuador,1975,55053,71273,-16220,77.24243402
Uzbekistan,2001,132542,171629,-39087,77.22587675
El Salvador,2003,29395,38074,-8679,77.20491674
South Korea,1988,190194,246352,-56158,77.20416315
Sri Lanka,1959,87971,114021,-26050,77.1533314
Uzbekistan,2013,145672,188825,-43153,77.14656428
El Salvador,2013,34247,44394,-10147,77.14330765
El Salvador,2006,31453,40776,-9323,77.13606043
El Salvador,2004,30058,38975,-8917,77.12123156
Uzbekistan,2019,154569,200442,-45873,77.11407789
Uzbekistan,2004,131287,170355,-39068,77.06671363
El Salvador,2005,30933,40151,-9218,77.0416677
Antigua and Barbuda,2009,372,483,-111,77.01863354
Sri Lanka,2003,115495,149987,-34492,77.00334029
Egypt,1967,440161,571701,-131540,76.99146932
Guyana,1990,4878,6337,-1459,76.9764873
Jamaica,2006,13682,17777,-4095,76.9646172
Moldova,2002,41853,54401,-12548,76.93424753
El Salvador,2008,31594,41083,-9489,76.9028552
South Korea,1987,193954,252275,-58321,76.88197404
Nicaragua,2013,21381,27816,-6435,76.86583261
Venezuela,1967,62083,80800,-18717,76.83539604
Brazil,1989,814726,1060454,-245728,76.8280378
South Korea,1989,188993,246133,-57140,76.78490897
Albania,2007,14528,18935,-4407,76.72564035
Saint Lucia,2011,969,1263,-294,76.72209026
Armenia,1986,19410,25306,-5896,76.70117759
Turkey,2010,294501,384167,-89666,76.6596298
Kyrgyzstan,1986,29083,38032,-8949,76.46981489
Georgia,1994,41596,54397,-12801,76.46745225
Nicaragua,2015,22359,29251,-6892,76.43841236
Cyprus,2005,5425,7099,-1674,76.41921397
Cyprus,2000,5369,7026,-1657,76.41616852
Cyprus,2007,5380,7043,-1663,76.38790288
Argentina,1966,153893,201504,-47611,76.3721812
Egypt,1974,457620,599313,-141693,76.35742926
Cyprus,2020,6532,8566,-2034,76.25496148
Brazil,1986,810460,1063459,-252999,76.20980216
Sri Lanka,2000,116200,152525,-36325,76.18423209
Brazil,1992,825240,1083595,-258355,76.15760501
Singapore,2019,20288,26644,-6356,76.14472301
Brunei,2012,1216,1597,-381,76.14276769
Colombia,1954,150761,198066,-47305,76.11654701
Belize,1987,761,1000,-239,76.1
Panama,1964,8454,11110,-2656,76.09360936
Venezuela,1966,61521,80969,-19448,75.98093097
Syria,2001,52832,69601,-16769,75.90695536
Sri Lanka,1958,90815,119680,-28865,75.88151738
Brazil,1984,809190,1067176,-257986,75.82535589
Panama,1961,8435,11131,-2696,75.77935495
El Salvador,1993,28783,37998,-9215,75.74872362
El Salvador,2007,31349,41389,-10040,75.742347
Brazil,1990,816434,1078578,-262144,75.69540636
Armenia,1987,19727,26085,-6358,75.6258386
Uzbekistan,2010,138408,183059,-44651,75.6084104
Uzbekistan,1999,130529,172665,-42136,75.59667564
Egypt,1973,459816,608925,-149109,75.51274788
Cyprus,2019,6262,8301,-2039,75.43669437
Egypt,1975,448433,594716,-146283,75.40288138
Thailand,1982,247402,328202,-80800,75.38101535
Egypt,1976,444228,589536,-145308,75.35214135
Antigua and Barbuda,1988,363,482,-119,75.31120332
Brazil,1987,798818,1060998,-262180,75.28930309
Suriname,1978,2730,3627,-897,75.2688172
Oman,2020,10526,13991,-3465,75.23407905
Azerbaijan,2002,46526,61866,-15340,75.20447419
Panama,1985,8991,11956,-2965,75.20073603
Qatar,2019,2087,2776,-689,75.18011527
Suriname,1980,2695,3587,-892,75.13242264
Nicaragua,2012,20300,27021,-6721,75.12675327
Belize,1993,819,1091,-272,75.06874427
Cuba,1964,47996,63943,-15947,75.06060085
Venezuela,1964,61281,81646,-20365,75.05695319
Kuwait,2019,7306,9734,-2428,75.05650298
El Salvador,2002,27476,36637,-9161,74.99522341
Venezuela,1965,60857,81188,-20331,74.95812189
Suriname,2011,2989,3989,-1000,74.93106042
Sri Lanka,2001,112858,150668,-37810,74.90508934
Belize,1984,785,1048,-263,74.90458015
Dominican Republic,2014,44934,60004,-15070,74.88500767
South Africa,1996,290833,388444,-97611,74.87128132
Dominica,2001,510,682,-172,74.78005865
Panama,1960,8387,11218,-2831,74.76377251
Dominica,2017,601,805,-204,74.65838509
Thailand,1980,247970,332147,-84177,74.65670321
Sri Lanka,1957,92759,124265,-31506,74.64611918
Cyprus,2004,5225,7000,-1775,74.64285714
Cyprus,2014,5539,7421,-1882,74.63953645
Egypt,1980,421227,564397,-143170,74.633104
Suriname,2008,2972,3984,-1012,74.59839357
Guyana,1993,4514,6053,-1539,74.57459111
Montenegro,2019,5069,6801,-1732,74.53315689
Paraguay,2008,23338,31335,-7997,74.47901707
Dominica,2009,559,751,-192,74.43408788
Sri Lanka,2002,111863,150312,-38449,74.42053861
Bahrain,1985,1097,1476,-379,74.32249322
Jamaica,1989,12190,16417,-4227,74.25229945
Moldova,2000,41224,55528,-14304,74.24002305
Panama,1957,8579,11567,-2988,74.16789142
Belize,1989,744,1004,-260,74.10358566
Georgia,1997,37679,50885,-13206,74.0473617
Brazil,1991,802292,1083804,-281512,74.02556182
Cyprus,2012,5500,7432,-1932,74.00430571
Turkey,2009,281504,380439,-98935,73.99451686
Syria,2004,53325,72079,-18754,73.98132605
Paraguay,2007,23007,31125,-8118,73.91807229
Dominica,2010,589,797,-208,73.902133
Dominica,1987,455,616,-161,73.86363636
Brazil,1985,787341,1066387,-279046,73.83257673
Jamaica,1990,12172,16496,-4324,73.78758487
El Salvador,2012,32122,43538,-11416,73.77922734
Nicaragua,2011,19523,26475,-6952,73.74126534
Panama,1988,9382,12731,-3349,73.69413243
Egypt,1965,411636,558711,-147075,73.67601497
Dominica,2012,618,839,-221,73.659118
Mongolia,1994,14986,20354,-5368,73.62680554
Moldova,2001,40076,54472,-14396,73.57174328
Suriname,1989,2326,3163,-837,73.53778059
Suriname,2013,3147,4280,-1133,73.52803738
Belize,1970,797,1084,-287,73.52398524
Dominica,1990,512,697,-185,73.45767575
Panama,1986,8942,12177,-3235,73.43352221
Fiji,1978,3272,4457,-1185,73.41260938
Tajikistan,2016,34126,46502,-12376,73.38609092
Azerbaijan,2000,46701,63647,-16946,73.3750216
Saint Lucia,2000,818,1115,-297,73.3632287
Panama,1987,9105,12429,-3324,73.25609462
Paraguay,2006,22728,31028,-8300,73.24996777
Venezuela,1957,61814,84400,-22586,73.23933649
Saint Vincent and the Grenadines,2021,1027,1403,-376,73.2002851
Guyana,1991,4549,6217,-1668,73.17033939
Uzbekistan,2009,133610,182611,-49001,73.16645766
Philippines,1963,215743,294919,-79176,73.1533065
Cyprus,1999,5071,6947,-1876,72.99553764
Dominica,1981,340,466,-126,72.96137339
Guyana,1999,4197,5753,-1556,72.95324179
Oman,2021,12546,17206,-4660,72.9164245
Azerbaijan,1994,54921,75356,-20435,72.88205319
Cyprus,2009,5182,7121,-1939,72.77067828
Panama,1983,8499,11691,-3192,72.69694637
Panama,1977,8036,11063,-3027,72.63852481
Nicaragua,2010,19147,26364,-7217,72.62554999
Panama,1979,8221,11323,-3102,72.60443345
United Arab Emirates,2018,8784,12102,-3318,72.58304412
Belize,1977,759,1046,-287,72.56214149
Georgia,1995,37874,52226,-14352,72.51943476
Cyprus,2008,5194,7169,-1975,72.45082996
Thailand,1981,239423,330480,-91057,72.44704672
Thailand,1985,225088,310818,-85730,72.41794233
Belize,1973,777,1073,-296,72.4137931
Paraguay,2004,21787,30110,-8323,72.35802059
Cyprus,2011,5248,7257,-2009,72.31638418
Cyprus,2018,5813,8042,-2229,72.28301418
Suriname,2014,3150,4359,-1209,72.2642808
Dominica,2005,489,677,-188,72.23042836
El Salvador,1992,27900,38639,-10739,72.20683765
Brazil,1983,770736,1067947,-297211,72.1698736
Dominica,2014,614,851,-237,72.15041128
Suriname,2009,2807,3891,-1084,72.14083783
Saint Kitts and Nevis,1969,414,574,-160,72.12543554
Philippines,1964,214936,298142,-83206,72.09182202
Venezuela,1955,59329,82412,-23083,71.99072951
Azerbaijan,2001,45284,62907,-17623,71.98562958
Dominica,1991,518,720,-202,71.94444444
Egypt,1978,415605,577690,-162085,71.94256435
Panama,1956,8352,11611,-3259,71.93178882
Guyana,1994,4304,5986,-1682,71.90110257
Cyprus,2006,5127,7131,-2004,71.8973496
Panama,1958,8234,11460,-3226,71.84991274
Mexico,1956,368740,513334,-144594,71.83237424
Dominica,1989,497,692,-195,71.82080925
Sri Lanka,1955,94368,131593,-37225,71.71202116
Paraguay,2005,22069,30788,-8719,71.68052488
Venezuela,1963,58269,81404,-23135,71.58002064
Belize,1967,811,1133,-322,71.57987643
Belize,1994,763,1066,-303,71.57598499
Venezuela,1956,59366,82953,-23587,71.56582643
Thailand,1979,241111,336933,-95822,71.56051797
Suriname,1979,2575,3600,-1025,71.52777778
Syria,2003,49998,69988,-19990,71.43796079
Venezuela,1958,59766,83664,-23898,71.43574297
Egypt,1971,427467,598847,-171380,71.38167178
Thailand,1986,218025,305499,-87474,71.36684572
Dominica,2013,619,868,-249,71.31336406
Dominica,1983,345,484,-139,71.28099174
Guyana,1984,4781,6708,-1927,71.27310674
Azerbaijan,1999,46295,65053,-18758,71.16505004
Thailand,1984,225282,316927,-91645,71.0832463
Suriname,1975,2670,3757,-1087,71.06734096
Panama,1962,7871,11083,-3212,71.01867725
Armenia,1988,35567,50189,-14622,70.86612604
Moldova,1997,42241,59610,-17369,70.86227143
Cyprus,2016,5472,7726,-2254,70.82578307
Thailand,1974,246459,347996,-101537,70.82236577
Dominican Republic,2018,46260,65334,-19074,70.80539994
Cyprus,2013,5272,7452,-2180,70.74610843
Cyprus,2010,5095,7205,-2110,70.7147814
Suriname,2007,2874,4065,-1191,70.70110701
Armenia,1982,17469,24802,-7333,70.43383598
Thailand,1977,236783,336505,-99722,70.36537347
Suriname,1999,2511,3570,-1059,70.33613445
Moldova,1999,41314,58751,-17437,70.32050518
Costa Rica,1961,9726,13853,-4127,70.20861907
Panama,1982,8142,11597,-3455,70.20781237
Tajikistan,1988,35334,50343,-15009,70.18652047
Malaysia,2018,117387,167497,-50110,70.08304626
Azerbaijan,1995,50828,72552,-21724,70.05733819
Suriname,1963,2400,3430,-1030,69.97084548
Singapore,2020,20985,29992,-9007,69.96865831
Antigua and Barbuda,1983,312,446,-134,69.95515695
Brazil,1981,749355,1071389,-322034,69.94238321
Panama,1984,8250,11801,-3551,69.90932972
Suriname,1976,2593,3711,-1118,69.8733495
Belize,1975,723,1035,-312,69.85507246
Jamaica,1986,12063,17275,-5212,69.829233
Iran,2014,272822,390733,-117911,69.8231273
Brazil,1980,749644,1073639,-323995,69.8227244
Belize,1991,742,1063,-321,69.80244591
Jamaica,1988,11755,16864,-5109,69.70469639
Dominica,1988,424,609,-185,69.62233169
Panama,1980,7959,11436,-3477,69.59601259
Panama,1955,8042,11558,-3516,69.57951203
Suriname,1985,2275,3270,-995,69.57186544
Cape Verde,1980,2281,3280,-999,69.54268293
Tajikistan,1981,31637,45498,-13861,69.53492461
Suriname,1991,2165,3115,-950,69.5024077
Jamaica,1981,11849,17051,-5202,69.49152542
Suriname,1982,2377,3423,-1046,69.44200993
Sri Lanka,2009,127776,184037,-56261,69.42951689
Tajikistan,1982,32053,46208,-14155,69.36677632
Venezuela,1959,57260,82574,-25314,69.34386126
Tajikistan,2017,32024,46184,-14160,69.34003118
Brazil,1982,740966,1069020,-328054,69.31264148
Suriname,1984,2290,3304,-1014,69.30992736
Panama,1981,7976,11522,-3546,69.22409304
Thailand,1975,237018,342433,-105415,69.21587581
Thailand,1978,233216,337052,-103836,69.19288418
Barbados,2001,1712,2478,-766,69.08797417
Venezuela,1961,55466,80296,-24830,69.07691541
Iran,2013,266115,385336,-119221,69.06050823
Thailand,1972,248676,360229,-111553,69.03275416
Azerbaijan,1993,52809,76562,-23753,68.97547086
Suriname,2000,2572,3734,-1162,68.88055704
Panama,1989,9557,13876,-4319,68.87431536
Azerbaijan,1998,46299,67274,-20975,68.82153581
Azerbaijan,1988,47485,69010,-21525,68.80886828
Sri Lanka,1956,87561,127677,-40116,68.58008882
Suriname,1977,2516,3670,-1154,68.55585831
Nicaragua,2009,18179,26603,-8424,68.33439838
Suriname,1971,2640,3865,-1225,68.30530401
Moldova,1998,39922,58597,-18675,68.12976774
Suriname,2002,2818,4137,-1319,68.11699299
Tajikistan,2005,28913,42465,-13552,68.0866596
Belize,1969,754,1108,-354,68.05054152
El Salvador,1991,27096,39818,-12722,68.0496258
Suriname,2012,2815,4144,-1329,67.92953668
Venezuela,1960,55019,81029,-26010,67.90038134
Belize,1966,772,1138,-366,67.83831283
Azerbaijan,1981,42898,63329,-20431,67.73831894
Dominica,2000,426,629,-203,67.72655008
Armenia,1981,16659,24598,-7939,67.72501829
Azerbaijan,1996,48242,71260,-23018,67.69856862
Thailand,1973,239151,353651,-114500,67.62344798
Dominica,2011,603,893,-290,67.52519597
Belize,1974,721,1068,-347,67.5093633
Peru,2019,132773,196738,-63965,67.4872165
Belize,1983,719,1066,-347,67.44840525
Azerbaijan,1997,46961,69635,-22674,67.43878797
Panama,1978,7555,11207,-3652,67.41322388
Azerbaijan,1992,51258,76073,-24815,67.38001656
Venezuela,1962,54938,81738,-26800,67.21231251
Belize,1990,685,1020,-335,67.15686275
Azerbaijan,1985,45179,67333,-22154,67.09785692
El Salvador,1990,28224,42086,-13862,67.06268118
Jordan,2012,17557,26192,-8635,67.03191814
Azerbaijan,1987,45744,68307,-22563,66.9682463
Tajikistan,1987,33543,50093,-16550,66.9614517
Suriname,1981,2345,3503,-1158,66.94262061
Georgia,1996,34414,51416,-17002,66.93247238
Dominican Republic,2016,41953,62878,-20925,66.72126976
Nicaragua,2008,18254,27424,-9170,66.56213536
Suriname,2001,2620,3937,-1317,66.5481331
Paraguay,2003,19779,29742,-9963,66.50191648
Azerbaijan,1986,45344,68367,-23023,66.32439627
Suriname,2005,2812,4244,-1432,66.25824694
Brazil,1979,710702,1073778,-363076,66.1870517
Dominican Republic,2017,42542,64319,-21777,66.14219748
Belize,1982,703,1063,-360,66.1335842
Jamaica,1991,11181,16909,-5728,66.12454906
Tajikistan,1985,32014,48437,-16423,66.09410162
Jordan,2011,16892,25564,-8672,66.0772962
Azerbaijan,1982,42376,64398,-22022,65.80328582
Jordan,2015,19190,29297,-10107,65.50158719
Suriname,2006,2723,4158,-1435,65.48821549
Suriname,1990,2061,3148,-1087,65.47013977
Suriname,1998,2204,3372,-1168,65.36180308
Dominican Republic,2015,39933,61310,-21377,65.13293101
Tajikistan,1989,33395,51304,-17909,65.09239046
United Arab Emirates,2019,8798,13552,-4754,64.92030697
Tajikistan,1986,31993,49324,-17331,64.86294704
Thailand,1969,243444,375652,-132208,64.80572445
Paraguay,2000,18616,28841,-10225,64.54699906
Guyana,1992,3972,6178,-2206,64.29265134
Peru,2018,125590,195538,-69948,64.22792501
Suriname,2004,2788,4344,-1556,64.18047882
Belize,1964,729,1136,-407,64.17253521
Thailand,1976,215855,336727,-120872,64.10385862
Paraguay,2002,18934,29625,-10691,63.91223629
Jamaica,1982,10799,16912,-6113,63.85406812
Belize,1968,714,1119,-405,63.80697051
Dominican Republic,2013,37585,59034,-21449,63.66670055
Suriname,1965,2378,3741,-1363,63.56589147
Suriname,1964,2289,3605,-1316,63.49514563
Malaysia,2019,109164,172154,-62990,63.41066719
Tajikistan,1993,49326,77832,-28506,63.37496146
United Arab Emirates,2020,10357,16406,-6049,63.12934292
Suriname,2003,2746,4350,-1604,63.12643678
Jordan,2010,15731,24977,-9246,62.98194339
Paraguay,2001,18400,29221,-10821,62.96841313
Thailand,1971,227990,362677,-134687,62.86309857
Belize,1979,651,1037,-386,62.77724204
Belize,1965,710,1131,-421,62.77630416
Tajikistan,1990,33020,52655,-19635,62.71009401
Belize,1972,669,1067,-398,62.69915651
Tajikistan,2004,26770,42855,-16085,62.46645666
Azerbaijan,1989,44016,70555,-26539,62.38537311
Sri Lanka,2004,114915,184233,-69318,62.37481884
Peru,2017,121142,194790,-73648,62.19107757
Jamaica,1980,10619,17118,-6499,62.03411614
Dominican Republic,2012,36118,58287,-22169,61.96578997
Malaysia,2020,109155,176170,-67015,61.9600386
Tajikistan,2003,26784,43280,-16496,61.88539741
Tajikistan,1994,39943,64679,-24736,61.75574762
Guyana,1988,4021,6513,-2492,61.73806234
Tajikistan,2002,27230,44521,-17291,61.1621482
Suriname,1992,1887,3089,-1202,61.08773066
Azerbaijan,1991,44659,73129,-28470,61.06879624
Dominica,1979,304,499,-195,60.92184369
Suriname,1966,2274,3736,-1462,60.86723769
Suriname,1986,2002,3298,-1296,60.70345664
Lebanon,2019,18544,30554,-12010,60.69254435
Thailand,1970,223899,369462,-145563,60.6013609
Tajikistan,1991,33067,54618,-21551,60.54231206
Nicaragua,2007,17312,28708,-11396,60.30374808
Jordan,2009,14807,24576,-9769,60.24983724
Dominican Republic,1985,27844,46467,-18623,59.92209525
Azerbaijan,1990,42819,71512,-28693,59.87666406
Peru,1996,92674,154949,-62275,59.80935663
Jordan,2008,14355,24025,-9670,59.75026015
Dominican Republic,1984,28236,47352,-19116,59.63000507
Jordan,2016,18736,31492,-12756,59.49447479
Malaysia,2017,97440,163884,-66444,59.45668888
Peru,1995,91485,154011,-62526,59.40160118
Suriname,1996,1828,3079,-1251,59.3699253
Lebanon,2020,21197,35782,-14585,59.23928232
Lebanon,2021,27579,46727,-19148,59.02155071
Suriname,1997,1890,3204,-1314,58.98876404
Albania,2010,12139,20583,-8444,58.97585386
Peru,1998,91469,156457,-64988,58.4627086
Tajikistan,2001,26737,45966,-19229,58.16690597
Belize,1971,618,1063,-445,58.13734713
Jordan,2017,18628,32164,-13536,57.91568213
Tajikistan,1995,34274,59438,-25164,57.66344763
Iraq,2015,107909,187339,-79430,57.60092666
Peru,1997,89790,155930,-66140,57.58353107
Malaysia,2004,64785,113037,-48252,57.31309217
Malaysia,2008,76016,132667,-56651,57.2983485
Iraq,2016,112830,198653,-85823,56.79753137
Malaysia,2005,65941,116415,-50474,56.64304428
Malaysia,2003,61748,109018,-47270,56.64018786
Malaysia,2006,68124,121343,-53219,56.14168102
Malaysia,2007,71030,126781,-55751,56.02574518
Peru,1999,86539,155170,-68631,55.77044532
Dominican Republic,1990,24151,43415,-19264,55.62823909
Dominican Republic,2004,30656,55159,-24503,55.57751228
Peru,2004,90463,163439,-72976,55.34970234
Dominican Republic,2011,32048,57930,-25882,55.32194027
Peru,2003,88060,159276,-71216,55.28767674
Dominican Republic,1983,26542,48087,-21545,55.19579096
Dominican Republic,2005,29991,54460,-24469,55.06977598
Iraq,2008,106245,193004,-86759,55.04808191
Suriname,1988,1780,3234,-1454,55.0401979
Dominican Republic,1967,29472,53761,-24289,54.82040885
Dominican Republic,1991,23667,43177,-19510,54.81390555
Tajikistan,2000,25899,47362,-21463,54.68307926
Peru,2000,84393,154375,-69982,54.66753036
Dominican Republic,1982,26589,48712,-22123,54.58408606
Nicaragua,2005,16757,30718,-13961,54.55107754
Malaysia,2002,57645,106385,-48740,54.18527048
Malaysia,2001,56309,103942,-47633,54.17348136
Dominican Republic,1987,24253,44786,-20533,54.15308355
Dominican Republic,1998,27043,49986,-22943,54.10114832
Dominican Republic,1972,27538,51149,-23611,53.83878473
Dominican Republic,1999,27585,51336,-23751,53.7342216
Suriname,1987,1746,3273,-1527,53.34555454
Dominican Republic,1989,23343,43771,-20428,53.32983025
Tajikistan,1996,31792,59638,-27846,53.30829337
Malaysia,2016,85637,160803,-75166,53.25584722
Dominican Republic,1997,25491,47991,-22500,53.11620929
Nicaragua,2006,15716,29711,-13995,52.89623372
Dominican Republic,1988,23358,44186,-20828,52.86289775
Peru,2005,89166,169011,-79845,52.75751282
Dominican Republic,1968,27834,53015,-25181,52.50212204
Tajikistan,1998,27397,52514,-25117,52.17084968
Dominican Republic,2003,28317,54421,-26104,52.03322247
Peru,2002,81192,156445,-75253,51.89811116
Dominican Republic,1969,27065,52248,-25183,51.80102588
Tajikistan,1999,25495,49275,-23780,51.74023338
Dominican Republic,1973,26429,51101,-24672,51.71914444
Dominican Republic,1974,26294,50890,-24596,51.66830419
Peru,2001,79809,154868,-75059,51.53356407
Dominican Republic,1995,23090,44901,-21811,51.42424445
Tajikistan,1997,28710,55903,-27193,51.35681448
Dominican Republic,1996,23696,46426,-22730,51.04036531
Dominican Republic,2010,29086,56997,-27911,51.030756
Malaysia,2015,80691,158136,-77445,51.02633177
Tajikistan,1992,36718,72031,-35313,50.97527453
Dominican Republic,1992,21937,43090,-21153,50.90972383
Malaysia,2014,77365,152233,-74868,50.82012441
Suriname,1995,1535,3028,-1493,50.69352708
Dominican Republic,1975,25541,50612,-25071,50.46431676
Dominican Republic,1981,24743,49460,-24717,50.02628387
Dominican Republic,1979,25757,51641,-25884,49.87703569
Malaysia,2013,74147,148763,-74616,49.84236672
Dominican Republic,1976,25125,50413,-25288,49.83833535
Dominican Republic,1977,25009,50262,-25253,49.7572719
Dominican Republic,1980,24959,50225,-25266,49.69437531
Malaysia,2000,51960,104767,-52807,49.59576966
Peru,2016,97241,196432,-99191,49.50364503
Malaysia,2012,71848,145323,-73475,49.44021249
Dominican Republic,1994,21490,43524,-22034,49.37505744
Malaysia,2011,70836,143561,-72725,49.34209152
Dominican Republic,1971,25235,51163,-25928,49.32275277
Peru,2010,99334,202144,-102810,49.14021688
Peru,2013,98616,200988,-102372,49.06561586
Jordan,2018,16087,32893,-16806,48.90706229
Peru,2015,96240,197692,-101452,48.68178783
Malaysia,2009,67488,139454,-71966,48.39445265
Peru,2012,97951,202404,-104453,48.39380645
Dominican Republic,1970,24925,51520,-26595,48.37927019
Peru,2009,95722,198041,-102319,48.3344358
Dominican Republic,1986,21975,45586,-23611,48.20558944
Peru,2014,96459,200838,-104379,48.02826158
Dominican Republic,2002,26149,54638,-28489,47.85863319
Dominican Republic,2001,25735,53845,-28110,47.7945956
Peru,2008,91290,191045,-99755,47.78455338
Peru,2011,96852,202823,-105971,47.75198079
Malaysia,2010,68518,143564,-75046,47.72644953
Peru,2007,87497,184258,-96761,47.48613357
Peru,2006,82620,176043,-93423,46.93171555
Dominican Republic,2006,25335,54611,-29276,46.39175258
Dominican Republic,1978,23127,50171,-27044,46.09635048
Dominican Republic,2009,25546,56354,-30808,45.33129858
Dominican Republic,2000,23917,52790,-28873,45.30592915
Dominican Republic,2008,24755,55629,-30874,44.50017077
Dominican Republic,2007,24514,55179,-30665,44.42632161
Dominican Republic,1965,23877,58644,-34767,40.71516268
Dominican Republic,1966,21626,54380,-32754,39.76829717